Poker Hand #RC211928551: Omaha Pot Limit  ($0.01/$0.02) - 2022/10/21 12:58:17
Table 'RushAndCash1778551' 6-max Seat #1 is the button
Seat 1: 223f5e09 ($4 in chips)
Seat 2: 9b781057 ($2 in chips)
Seat 3: Hero ($2.17 in chips)
Seat 4: ca792926 ($2 in chips)
Seat 5: 65950a71 ($0.9 in chips)
Seat 6: 53141459 ($2.58 in chips)
9b781057: posts small blind $0.01
Hero: posts big blind $0.02
*** HOLE CARDS ***
Dealt to 223f5e09 
Dealt to 9b781057 
Dealt to Hero [Jh 8c 2d 2h]
Dealt to ca792926 
Dealt to 65950a71 
Dealt to 53141459 
ca792926: folds
65950a71: calls $0.02
53141459: folds
223f5e09: folds
9b781057: calls $0.01
Hero: checks
*** FLOP *** [8s Qs 8d]
9b781057: checks
Hero: checks
65950a71: bets $0.03
9b781057: folds
Hero: folds
Uncalled bet ($0.03) returned to 65950a71
*** SHOWDOWN ***
65950a71 collected $0.06 from pot
*** SUMMARY ***
Total pot $0.06 | Rake $0 | Jackpot $0 | Bingo $0
Board [8s Qs 8d]
Seat 1: 223f5e09 (button) folded before Flop (didn't bet)
Seat 2: 9b781057 (small blind) folded on the Flop
Seat 3: Hero (big blind) folded on the Flop
Seat 4: ca792926 folded before Flop (didn't bet)
Seat 5: 65950a71 won ($0.06)
Seat 6: 53141459 folded before Flop (didn't bet)


Poker Hand #RC211928540: Omaha Pot Limit  ($0.01/$0.02) - 2022/10/21 12:58:11
Table 'RushAndCash1778540' 6-max Seat #1 is the button
Seat 1: 4065cf4 ($2.88 in chips)
Seat 2: 7a63c988 ($2 in chips)
Seat 3: 61b92208 ($23.8 in chips)
Seat 4: 68d66666 ($2.45 in chips)
Seat 5: Hero ($2.17 in chips)
Seat 6: ca792926 ($2 in chips)
7a63c988: posts small blind $0.01
61b92208: posts big blind $0.02
*** HOLE CARDS ***
Dealt to 4065cf4 
Dealt to 7a63c988 
Dealt to 61b92208 
Dealt to 68d66666 
Dealt to Hero [7d 9s 8d 3s]
Dealt to ca792926 
68d66666: calls $0.02
Hero: folds
ca792926: folds
4065cf4: folds
7a63c988: folds
61b92208: raises $0.02 to $0.04
68d66666: calls $0.02
*** FLOP *** [4h 5h Jd]
61b92208: checks
68d66666: checks
*** TURN *** [4h 5h Jd] [Qc]
61b92208: checks
68d66666: checks
*** RIVER *** [4h 5h Jd Qc] [6c]
61b92208: checks
68d66666: checks
61b92208: shows [Kc 7s 9d 9c] (Pair of Nines)
68d66666: shows [Ts As 2h 2c] (Pair of Twos)
*** SHOWDOWN ***
61b92208 collected $0.09 from pot
*** SUMMARY ***
Total pot $0.09 | Rake $0 | Jackpot $0 | Bingo $0
Board [4h 5h Jd Qc 6c]
Seat 1: 4065cf4 (button) folded before Flop (didn't bet)
Seat 2: 7a63c988 (small blind) folded before Flop
Seat 3: 61b92208 (big blind) showed [Kc 7s 9d 9c] and won ($0.09) with Pair of Nines
Seat 4: 68d66666 showed [Ts As 2h 2c] and lost with Pair of Twos
Seat 5: Hero folded before Flop (didn't bet)
Seat 6: ca792926 folded before Flop (didn't bet)


Poker Hand #RC211928522: Omaha Pot Limit  ($0.01/$0.02) - 2022/10/21 12:58:04
Table 'RushAndCash1778522' 6-max Seat #1 is the button
Seat 1: c0930254 ($3.41 in chips)
Seat 2: 899f8992 ($2 in chips)
Seat 3: 3a79e1dc ($2 in chips)
Seat 4: Hero ($2.17 in chips)
Seat 5: 1e9ff1cd ($2.75 in chips)
Seat 6: 95a39865 ($8.61 in chips)
899f8992: posts small blind $0.01
3a79e1dc: posts big blind $0.02
*** HOLE CARDS ***
Dealt to c0930254 
Dealt to 899f8992 
Dealt to 3a79e1dc 
Dealt to Hero [9h 6d Ac 4d]
Dealt to 1e9ff1cd 
Dealt to 95a39865 
Hero: folds
1e9ff1cd: folds
95a39865: raises $0.03 to $0.05
c0930254: folds
899f8992: folds
3a79e1dc: calls $0.03
*** FLOP *** [As Qh 6s]
3a79e1dc: checks
95a39865: checks
*** TURN *** [As Qh 6s] [3c]
3a79e1dc: bets $0.06
95a39865: folds
Uncalled bet ($0.06) returned to 3a79e1dc
*** SHOWDOWN ***
3a79e1dc collected $0.11 from pot
*** SUMMARY ***
Total pot $0.11 | Rake $0 | Jackpot $0 | Bingo $0
Board [As Qh 6s 3c]
Seat 1: c0930254 (button) folded before Flop (didn't bet)
Seat 2: 899f8992 (small blind) folded before Flop
Seat 3: 3a79e1dc (big blind) won ($0.11)
Seat 4: Hero folded before Flop (didn't bet)
Seat 5: 1e9ff1cd folded before Flop (didn't bet)
Seat 6: 95a39865 folded on the Turn


Poker Hand #RC211928499: Omaha Pot Limit  ($0.01/$0.02) - 2022/10/21 12:57:52
Table 'RushAndCash1778499' 6-max Seat #1 is the button
Seat 1: Hero ($2.17 in chips)
Seat 2: 68d66666 ($2.46 in chips)
Seat 3: 4859f1fc ($7.53 in chips)
Seat 4: 1d8bd8e2 ($2 in chips)
Seat 5: 65950a71 ($0.87 in chips)
Seat 6: 46cc7fae ($2 in chips)
68d66666: posts small blind $0.01
4859f1fc: posts big blind $0.02
*** HOLE CARDS ***
Dealt to Hero [Ks Th 3s 4h]
Dealt to 68d66666 
Dealt to 4859f1fc 
Dealt to 1d8bd8e2 
Dealt to 65950a71 
Dealt to 46cc7fae 
1d8bd8e2: folds
65950a71: raises $0.05 to $0.07
46cc7fae: folds
Hero: folds
68d66666: folds
4859f1fc: folds
Uncalled bet ($0.05) returned to 65950a71
*** SHOWDOWN ***
65950a71 collected $0.05 from pot
*** SUMMARY ***
Total pot $0.05 | Rake $0 | Jackpot $0 | Bingo $0
Seat 1: Hero (button) folded before Flop (didn't bet)
Seat 2: 68d66666 (small blind) folded before Flop
Seat 3: 4859f1fc (big blind) folded before Flop
Seat 4: 1d8bd8e2 folded before Flop (didn't bet)
Seat 5: 65950a71 collected ($0.05)
Seat 6: 46cc7fae folded before Flop (didn't bet)


Poker Hand #RC211928491: Omaha Pot Limit  ($0.01/$0.02) - 2022/10/21 12:57:48
Table 'RushAndCash1778491' 6-max Seat #1 is the button
Seat 1: ca792926 ($2 in chips)
Seat 2: Hero ($2.18 in chips)
Seat 3: 53141459 ($2.57 in chips)
Seat 4: 899f8992 ($2 in chips)
Seat 5: f5524b6e ($4.15 in chips)
Seat 6: 9b781057 ($2 in chips)
Hero: posts small blind $0.01
53141459: posts big blind $0.02
*** HOLE CARDS ***
Dealt to ca792926 
Dealt to Hero [9h 7s 3s Qs]
Dealt to 53141459 
Dealt to 899f8992 
Dealt to f5524b6e 
Dealt to 9b781057 
899f8992: folds
f5524b6e: folds
9b781057: folds
ca792926: folds
Hero: folds
Uncalled bet ($0.01) returned to 53141459
*** SHOWDOWN ***
53141459 collected $0.02 from pot
*** SUMMARY ***
Total pot $0.02 | Rake $0 | Jackpot $0 | Bingo $0
Seat 1: ca792926 (button) folded before Flop (didn't bet)
Seat 2: Hero (small blind) folded before Flop
Seat 3: 53141459 (big blind) collected ($0.02)
Seat 4: 899f8992 folded before Flop (didn't bet)
Seat 5: f5524b6e folded before Flop (didn't bet)
Seat 6: 9b781057 folded before Flop (didn't bet)


Poker Hand #RC211928482: Omaha Pot Limit  ($0.01/$0.02) - 2022/10/21 12:57:45
Table 'RushAndCash1778482' 6-max Seat #1 is the button
Seat 1: 6ef50542 ($4.72 in chips)
Seat 2: caac9df ($3.83 in chips)
Seat 3: Hero ($2.2 in chips)
Seat 4: 899f8992 ($2 in chips)
Seat 5: 691b15b3 ($4.06 in chips)
Seat 6: a5df1e48 ($2 in chips)
caac9df: posts small blind $0.01
Hero: posts big blind $0.02
*** HOLE CARDS ***
Dealt to 6ef50542 
Dealt to caac9df 
Dealt to Hero [6d 2d 5c 4s]
Dealt to 899f8992 
Dealt to 691b15b3 
Dealt to a5df1e48 
899f8992: folds
691b15b3: raises $0.05 to $0.07
a5df1e48: calls $0.07
6ef50542: folds
caac9df: folds
Hero: folds
*** FLOP *** [9c 8h 6h]
691b15b3: checks
a5df1e48: checks
*** TURN *** [9c 8h 6h] [Qd]
691b15b3: checks
a5df1e48: checks
*** RIVER *** [9c 8h 6h Qd] [Ac]
691b15b3: checks
a5df1e48: checks
691b15b3: shows [Js Qs 2c Jc] (Pair of Queens)
a5df1e48: shows [3h 4d 7h 3s] (Pair of Treys)
*** SHOWDOWN ***
691b15b3 collected $0.17 from pot
*** SUMMARY ***
Total pot $0.17 | Rake $0 | Jackpot $0 | Bingo $0
Board [9c 8h 6h Qd Ac]
Seat 1: 6ef50542 (button) folded before Flop (didn't bet)
Seat 2: caac9df (small blind) folded before Flop
Seat 3: Hero (big blind) folded before Flop
Seat 4: 899f8992 folded before Flop (didn't bet)
Seat 5: 691b15b3 showed [Js Qs 2c Jc] and won ($0.17) with Pair of Queens
Seat 6: a5df1e48 showed [3h 4d 7h 3s] and lost with Pair of Treys


Poker Hand #RC211928470: Omaha Pot Limit  ($0.01/$0.02) - 2022/10/21 12:57:41
Table 'RushAndCash1778470' 6-max Seat #1 is the button
Seat 1: 80892a00 ($10.36 in chips)
Seat 2: 1962c895 ($2.04 in chips)
Seat 3: c78ac035 ($2.18 in chips)
Seat 4: Hero ($2.2 in chips)
Seat 5: c0930254 ($3.43 in chips)
Seat 6: caac9df ($3.83 in chips)
1962c895: posts small blind $0.01
c78ac035: posts big blind $0.02
*** HOLE CARDS ***
Dealt to 80892a00 
Dealt to 1962c895 
Dealt to c78ac035 
Dealt to Hero [7d 7c 5s Ac]
Dealt to c0930254 
Dealt to caac9df 
Hero: folds
c0930254: folds
caac9df: folds
80892a00: folds
1962c895: raises $0.02 to $0.04
c78ac035: calls $0.02
*** FLOP *** [5c 5d Kc]
1962c895: checks
c78ac035: bets $0.04
1962c895: folds
Uncalled bet ($0.04) returned to c78ac035
*** SHOWDOWN ***
c78ac035 collected $0.08 from pot
*** SUMMARY ***
Total pot $0.08 | Rake $0 | Jackpot $0 | Bingo $0
Board [5c 5d Kc]
Seat 1: 80892a00 (button) folded before Flop (didn't bet)
Seat 2: 1962c895 (small blind) folded on the Flop
Seat 3: c78ac035 (big blind) won ($0.08)
Seat 4: Hero folded before Flop (didn't bet)
Seat 5: c0930254 folded before Flop (didn't bet)
Seat 6: caac9df folded before Flop (didn't bet)


Poker Hand #RC211928452: Omaha Pot Limit  ($0.01/$0.02) - 2022/10/21 12:57:31
Table 'RushAndCash1778452' 6-max Seat #1 is the button
Seat 1: Hero ($2.2 in chips)
Seat 2: 60c62cbf ($4.59 in chips)
Seat 3: ffcc6664 ($0.47 in chips)
Seat 4: 1d8bd8e2 ($2 in chips)
Seat 5: 88fd0c1c ($3.76 in chips)
Seat 6: 5e85d999 ($3.23 in chips)
60c62cbf: posts small blind $0.01
ffcc6664: posts big blind $0.02
*** HOLE CARDS ***
Dealt to Hero [As 3h 7h 9c]
Dealt to 60c62cbf 
Dealt to ffcc6664 
Dealt to 1d8bd8e2 
Dealt to 88fd0c1c 
Dealt to 5e85d999 
1d8bd8e2: folds
88fd0c1c: raises $0.05 to $0.07
5e85d999: folds
Hero: folds
60c62cbf: folds
ffcc6664: calls $0.05
*** FLOP *** [Js Td Ad]
ffcc6664: checks
88fd0c1c: checks
*** TURN *** [Js Td Ad] [6c]
ffcc6664: checks
88fd0c1c: checks
*** RIVER *** [Js Td Ad 6c] [4c]
ffcc6664: checks
88fd0c1c: checks
ffcc6664: shows [2h 6s 9h Kd] (Pair of Sixes)
88fd0c1c: shows [Kc 4d Kh 2d] (Pair of Kings)
*** SHOWDOWN ***
88fd0c1c collected $0.15 from pot
*** SUMMARY ***
Total pot $0.15 | Rake $0 | Jackpot $0 | Bingo $0
Board [Js Td Ad 6c 4c]
Seat 1: Hero (button) folded before Flop (didn't bet)
Seat 2: 60c62cbf (small blind) folded before Flop
Seat 3: ffcc6664 (big blind) showed [2h 6s 9h Kd] and lost with Pair of Sixes
Seat 4: 1d8bd8e2 folded before Flop (didn't bet)
Seat 5: 88fd0c1c showed [Kc 4d Kh 2d] and won ($0.15) with Pair of Kings
Seat 6: 5e85d999 folded before Flop (didn't bet)


Poker Hand #RC211928439: Omaha Pot Limit  ($0.01/$0.02) - 2022/10/21 12:57:24
Table 'RushAndCash1778439' 6-max Seat #1 is the button
Seat 1: 613e4690 ($1.57 in chips)
Seat 2: a57afaf3 ($2 in chips)
Seat 3: a6c42e85 ($1.87 in chips)
Seat 4: Hero ($2.17 in chips)
Seat 5: c78ac035 ($2.19 in chips)
Seat 6: 4530f74e ($2.87 in chips)
a57afaf3: posts small blind $0.01
a6c42e85: posts big blind $0.02
*** HOLE CARDS ***
Dealt to 613e4690 
Dealt to a57afaf3 
Dealt to a6c42e85 
Dealt to Hero [7h 9c 4h Kd]
Dealt to c78ac035 
Dealt to 4530f74e 
Hero: folds
c78ac035: folds
4530f74e: folds
613e4690: folds
a57afaf3: raises $0.04 to $0.06
a6c42e85: folds
Uncalled bet ($0.04) returned to a57afaf3
*** SHOWDOWN ***
a57afaf3 collected $0.04 from pot
*** SUMMARY ***
Total pot $0.04 | Rake $0 | Jackpot $0 | Bingo $0
Seat 1: 613e4690 (button) folded before Flop (didn't bet)
Seat 2: a57afaf3 (small blind) collected ($0.04)
Seat 3: a6c42e85 (big blind) folded before Flop
Seat 4: Hero folded before Flop (didn't bet)
Seat 5: c78ac035 folded before Flop (didn't bet)
Seat 6: 4530f74e folded before Flop (didn't bet)


Poker Hand #RC211928424: Omaha Pot Limit  ($0.01/$0.02) - 2022/10/21 12:57:17
Table 'RushAndCash1778424' 6-max Seat #1 is the button
Seat 1: da09ec79 ($5.97 in chips)
Seat 2: b415edae ($2.12 in chips)
Seat 3: 176da966 ($2.02 in chips)
Seat 4: Hero ($2.17 in chips)
Seat 5: ec3126a1 ($2.03 in chips)
Seat 6: a00fec6e ($4.29 in chips)
b415edae: posts small blind $0.01
176da966: posts big blind $0.02
*** HOLE CARDS ***
Dealt to da09ec79 
Dealt to b415edae 
Dealt to 176da966 
Dealt to Hero [3s 8h 5h 6s]
Dealt to ec3126a1 
Dealt to a00fec6e 
Hero: folds
ec3126a1: folds
a00fec6e: raises $0.05 to $0.07
da09ec79: folds
b415edae: folds
176da966: folds
Uncalled bet ($0.05) returned to a00fec6e
*** SHOWDOWN ***
a00fec6e collected $0.05 from pot
*** SUMMARY ***
Total pot $0.05 | Rake $0 | Jackpot $0 | Bingo $0
Seat 1: da09ec79 (button) folded before Flop (didn't bet)
Seat 2: b415edae (small blind) folded before Flop
Seat 3: 176da966 (big blind) folded before Flop
Seat 4: Hero folded before Flop (didn't bet)
Seat 5: ec3126a1 folded before Flop (didn't bet)
Seat 6: a00fec6e collected ($0.05)


Poker Hand #RC211928417: Omaha Pot Limit  ($0.01/$0.02) - 2022/10/21 12:57:14
Table 'RushAndCash1778417' 6-max Seat #1 is the button
Seat 1: 59e81d80 ($3.96 in chips)
Seat 2: 1d8bd8e2 ($2 in chips)
Seat 3: Hero ($2.19 in chips)
Seat 4: 60c62cbf ($4.59 in chips)
Seat 5: 53141459 ($2.58 in chips)
Seat 6: 21246ec4 ($2.36 in chips)
1d8bd8e2: posts small blind $0.01
Hero: posts big blind $0.02
*** HOLE CARDS ***
Dealt to 59e81d80 
Dealt to 1d8bd8e2 
Dealt to Hero [7h 7d 8c Tc]
Dealt to 60c62cbf 
Dealt to 53141459 
Dealt to 21246ec4 
60c62cbf: folds
53141459: folds
21246ec4: folds
59e81d80: folds
1d8bd8e2: folds
Uncalled bet ($0.01) returned to Hero
*** SHOWDOWN ***
Hero collected $0.02 from pot
*** SUMMARY ***
Total pot $0.02 | Rake $0 | Jackpot $0 | Bingo $0
Seat 1: 59e81d80 (button) folded before Flop (didn't bet)
Seat 2: 1d8bd8e2 (small blind) folded before Flop
Seat 3: Hero (big blind) collected ($0.02)
Seat 4: 60c62cbf folded before Flop (didn't bet)
Seat 5: 53141459 folded before Flop (didn't bet)
Seat 6: 21246ec4 folded before Flop (didn't bet)


Poker Hand #RC211928402: Omaha Pot Limit  ($0.01/$0.02) - 2022/10/21 12:57:03
Table 'RushAndCash1778402' 6-max Seat #1 is the button
Seat 1: 4305b6c1 ($5.73 in chips)
Seat 2: aa88fa2d ($7.74 in chips)
Seat 3: 4530f74e ($2.91 in chips)
Seat 4: 86010f0f ($6.99 in chips)
Seat 5: Hero ($2.19 in chips)
Seat 6: bc70dc6 ($2.06 in chips)
aa88fa2d: posts small blind $0.01
4530f74e: posts big blind $0.02
*** HOLE CARDS ***
Dealt to 4305b6c1 
Dealt to aa88fa2d 
Dealt to 4530f74e 
Dealt to 86010f0f 
Dealt to Hero [Tc 2s 4s 4h]
Dealt to bc70dc6 
86010f0f: raises $0.02 to $0.04
Hero: folds
bc70dc6: calls $0.04
4305b6c1: folds
aa88fa2d: folds
4530f74e: folds
*** FLOP *** [5d 7s 9s]
86010f0f: checks
bc70dc6: checks
*** TURN *** [5d 7s 9s] [Ts]
86010f0f: checks
bc70dc6: checks
*** RIVER *** [5d 7s 9s Ts] [Th]
86010f0f: checks
bc70dc6: checks
86010f0f: shows [Jc Qs Qc 9c] (Pair of Queens and Pair of Tens)
bc70dc6: shows [7d 6c 5h 9d] (Pair of Tens and Pair of Nines)
*** SHOWDOWN ***
86010f0f collected $0.11 from pot
*** SUMMARY ***
Total pot $0.11 | Rake $0 | Jackpot $0 | Bingo $0
Board [5d 7s 9s Ts Th]
Seat 1: 4305b6c1 (button) folded before Flop (didn't bet)
Seat 2: aa88fa2d (small blind) folded before Flop
Seat 3: 4530f74e (big blind) folded before Flop
Seat 4: 86010f0f showed [Jc Qs Qc 9c] and won ($0.11) with Pair of Queens and Pair of Tens
Seat 5: Hero folded before Flop (didn't bet)
Seat 6: bc70dc6 showed [7d 6c 5h 9d] and lost with Pair of Tens and Pair of Nines


Poker Hand #RC211928394: Omaha Pot Limit  ($0.01/$0.02) - 2022/10/21 12:56:59
Table 'RushAndCash1778394' 6-max Seat #1 is the button
Seat 1: Hero ($2.19 in chips)
Seat 2: 899f8992 ($2 in chips)
Seat 3: 1962c895 ($2.04 in chips)
Seat 4: 86010f0f ($6.99 in chips)
Seat 5: 1d97e8a9 ($2.27 in chips)
Seat 6: bc70dc6 ($2.06 in chips)
899f8992: posts small blind $0.01
1962c895: posts big blind $0.02
*** HOLE CARDS ***
Dealt to Hero [5s Ac Ks 2h]
Dealt to 899f8992 
Dealt to 1962c895 
Dealt to 86010f0f 
Dealt to 1d97e8a9 
Dealt to bc70dc6 
86010f0f: folds
1d97e8a9: folds
bc70dc6: folds
Hero: folds
899f8992: folds
Uncalled bet ($0.01) returned to 1962c895
*** SHOWDOWN ***
1962c895 collected $0.02 from pot
*** SUMMARY ***
Total pot $0.02 | Rake $0 | Jackpot $0 | Bingo $0
Seat 1: Hero (button) folded before Flop (didn't bet)
Seat 2: 899f8992 (small blind) folded before Flop
Seat 3: 1962c895 (big blind) collected ($0.02)
Seat 4: 86010f0f folded before Flop (didn't bet)
Seat 5: 1d97e8a9 folded before Flop (didn't bet)
Seat 6: bc70dc6 folded before Flop (didn't bet)


Poker Hand #RC211928386: Omaha Pot Limit  ($0.01/$0.02) - 2022/10/21 12:56:54
Table 'RushAndCash1778386' 6-max Seat #1 is the button
Seat 1: bba9eb10 ($0.37 in chips)
Seat 2: Hero ($2.2 in chips)
Seat 3: 1d8bd8e2 ($2 in chips)
Seat 4: 5978e0c1 ($2.03 in chips)
Seat 5: 4012dcfa ($1.5 in chips)
Seat 6: c47f1921 ($2.13 in chips)
Hero: posts small blind $0.01
1d8bd8e2: posts big blind $0.02
*** HOLE CARDS ***
Dealt to bba9eb10 
Dealt to Hero [9s Qs Td 3s]
Dealt to 1d8bd8e2 
Dealt to 5978e0c1 
Dealt to 4012dcfa 
Dealt to c47f1921 
5978e0c1: folds
4012dcfa: raises $0.02 to $0.04
c47f1921: folds
bba9eb10: folds
Hero: folds
1d8bd8e2: folds
Uncalled bet ($0.02) returned to 4012dcfa
*** SHOWDOWN ***
4012dcfa collected $0.05 from pot
*** SUMMARY ***
Total pot $0.05 | Rake $0 | Jackpot $0 | Bingo $0
Seat 1: bba9eb10 (button) folded before Flop (didn't bet)
Seat 2: Hero (small blind) folded before Flop
Seat 3: 1d8bd8e2 (big blind) folded before Flop
Seat 4: 5978e0c1 folded before Flop (didn't bet)
Seat 5: 4012dcfa collected ($0.05)
Seat 6: c47f1921 folded before Flop (didn't bet)


Poker Hand #RC211928378: Omaha Pot Limit  ($0.01/$0.02) - 2022/10/21 12:56:49
Table 'RushAndCash1778378' 6-max Seat #1 is the button
Seat 1: 2b16f681 ($0.37 in chips)
Seat 2: c0930254 ($3.42 in chips)
Seat 3: 73016c62 ($2 in chips)
Seat 4: 19209403 ($2.18 in chips)
Seat 5: Hero ($2.2 in chips)
Seat 6: c78ac035 ($2.22 in chips)
c0930254: posts small blind $0.01
73016c62: posts big blind $0.02
*** HOLE CARDS ***
Dealt to 2b16f681 
Dealt to c0930254 
Dealt to 73016c62 
Dealt to 19209403 
Dealt to Hero [8d 8s 5d Jh]
Dealt to c78ac035 
19209403: folds
Hero: folds
c78ac035: folds
2b16f681: folds
c0930254: folds
Uncalled bet ($0.01) returned to 73016c62
*** SHOWDOWN ***
73016c62 collected $0.02 from pot
*** SUMMARY ***
Total pot $0.02 | Rake $0 | Jackpot $0 | Bingo $0
Seat 1: 2b16f681 (button) folded before Flop (didn't bet)
Seat 2: c0930254 (small blind) folded before Flop
Seat 3: 73016c62 (big blind) collected ($0.02)
Seat 4: 19209403 folded before Flop (didn't bet)
Seat 5: Hero folded before Flop (didn't bet)
Seat 6: c78ac035 folded before Flop (didn't bet)


Poker Hand #RC211928368: Omaha Pot Limit  ($0.01/$0.02) - 2022/10/21 12:56:43
Table 'RushAndCash1778368' 6-max Seat #1 is the button
Seat 1: 46bd72d4 ($1.76 in chips)
Seat 2: Hero ($2.21 in chips)
Seat 3: 5332240a ($4.37 in chips)
Seat 4: c312dd38 ($2.08 in chips)
Seat 5: b10497f6 ($2.15 in chips)
Seat 6: a62396a8 ($3.59 in chips)
Hero: posts small blind $0.01
5332240a: posts big blind $0.02
*** HOLE CARDS ***
Dealt to 46bd72d4 
Dealt to Hero [8h 9c 4h 8c]
Dealt to 5332240a 
Dealt to c312dd38 
Dealt to b10497f6 
Dealt to a62396a8 
c312dd38: folds
b10497f6: folds
a62396a8: folds
46bd72d4: raises $0.02 to $0.04
Hero: folds
5332240a: calls $0.02
*** FLOP *** [Qh 2d Qd]
5332240a: bets $0.09
46bd72d4: calls $0.09
*** TURN *** [Qh 2d Qd] [3c]
5332240a: bets $0.27
46bd72d4: folds
Uncalled bet ($0.27) returned to 5332240a
*** SHOWDOWN ***
5332240a collected $0.26 from pot
*** SUMMARY ***
Total pot $0.27 | Rake $0.01 | Jackpot $0 | Bingo $0
Board [Qh 2d Qd 3c]
Seat 1: 46bd72d4 (button) folded on the Turn
Seat 2: Hero (small blind) folded before Flop
Seat 3: 5332240a (big blind) won ($0.26)
Seat 4: c312dd38 folded before Flop (didn't bet)
Seat 5: b10497f6 folded before Flop (didn't bet)
Seat 6: a62396a8 folded before Flop (didn't bet)


Poker Hand #RC211928264: Omaha Pot Limit  ($0.01/$0.02) - 2022/10/21 12:55:52
Table 'RushAndCash1778264' 6-max Seat #1 is the button
Seat 1: c312dd38 ($2 in chips)
Seat 2: 80892a00 ($10.46 in chips)
Seat 3: Hero ($2.28 in chips)
Seat 4: 9970a86e ($1.76 in chips)
Seat 5: 51d17ee8 ($1.49 in chips)
Seat 6: f2309695 ($3.36 in chips)
80892a00: posts small blind $0.01
Hero: posts big blind $0.02
*** HOLE CARDS ***
Dealt to c312dd38 
Dealt to 80892a00 
Dealt to Hero [Kc 6h Tc Jd]
Dealt to 9970a86e 
Dealt to 51d17ee8 
Dealt to f2309695 
9970a86e: folds
51d17ee8: folds
f2309695: folds
c312dd38: raises $0.05 to $0.07
80892a00: folds
Hero: calls $0.05
*** FLOP *** [4s Qs 7s]
Hero: checks
c312dd38: bets $0.08
Hero: folds
Uncalled bet ($0.08) returned to c312dd38
*** SHOWDOWN ***
c312dd38 collected $0.15 from pot
*** SUMMARY ***
Total pot $0.15 | Rake $0 | Jackpot $0 | Bingo $0
Board [4s Qs 7s]
Seat 1: c312dd38 (button) won ($0.15)
Seat 2: 80892a00 (small blind) folded before Flop
Seat 3: Hero (big blind) folded on the Flop
Seat 4: 9970a86e folded before Flop (didn't bet)
Seat 5: 51d17ee8 folded before Flop (didn't bet)
Seat 6: f2309695 folded before Flop (didn't bet)


Poker Hand #RC211928252: Omaha Pot Limit  ($0.01/$0.02) - 2022/10/21 12:55:46
Table 'RushAndCash1778252' 6-max Seat #1 is the button
Seat 1: 4065cf4 ($2.89 in chips)
Seat 2: c9fdfd48 ($1.92 in chips)
Seat 3: e9871fe ($1.48 in chips)
Seat 4: 3381ab97 ($1.75 in chips)
Seat 5: 1154b21f ($2.07 in chips)
Seat 6: Hero ($2.28 in chips)
c9fdfd48: posts small blind $0.01
e9871fe: posts big blind $0.02
*** HOLE CARDS ***
Dealt to 4065cf4 
Dealt to c9fdfd48 
Dealt to e9871fe 
Dealt to 3381ab97 
Dealt to 1154b21f 
Dealt to Hero [Qd 9d 2s Jc]
3381ab97: folds
1154b21f: folds
Hero: folds
4065cf4: folds
c9fdfd48: folds
Uncalled bet ($0.01) returned to e9871fe
*** SHOWDOWN ***
e9871fe collected $0.02 from pot
*** SUMMARY ***
Total pot $0.02 | Rake $0 | Jackpot $0 | Bingo $0
Seat 1: 4065cf4 (button) folded before Flop (didn't bet)
Seat 2: c9fdfd48 (small blind) folded before Flop
Seat 3: e9871fe (big blind) collected ($0.02)
Seat 4: 3381ab97 folded before Flop (didn't bet)
Seat 5: 1154b21f folded before Flop (didn't bet)
Seat 6: Hero folded before Flop (didn't bet)


Poker Hand #RC211928245: Omaha Pot Limit  ($0.01/$0.02) - 2022/10/21 12:55:42
Table 'RushAndCash1778245' 6-max Seat #1 is the button
Seat 1: Hero ($2.28 in chips)
Seat 2: 2b2cf699 ($8.59 in chips)
Seat 3: 60c62cbf ($4.61 in chips)
Seat 4: ca792926 ($2.07 in chips)
Seat 5: 4065cf4 ($2.89 in chips)
Seat 6: b10497f6 ($2.08 in chips)
2b2cf699: posts small blind $0.01
60c62cbf: posts big blind $0.02
*** HOLE CARDS ***
Dealt to Hero [Jc 7s 4s 6c]
Dealt to 2b2cf699 
Dealt to 60c62cbf 
Dealt to ca792926 
Dealt to 4065cf4 
Dealt to b10497f6 
ca792926: folds
4065cf4: folds
b10497f6: raises $0.05 to $0.07
Hero: folds
2b2cf699: folds
60c62cbf: folds
Uncalled bet ($0.05) returned to b10497f6
*** SHOWDOWN ***
b10497f6 collected $0.05 from pot
*** SUMMARY ***
Total pot $0.05 | Rake $0 | Jackpot $0 | Bingo $0
Seat 1: Hero (button) folded before Flop (didn't bet)
Seat 2: 2b2cf699 (small blind) folded before Flop
Seat 3: 60c62cbf (big blind) folded before Flop
Seat 4: ca792926 folded before Flop (didn't bet)
Seat 5: 4065cf4 folded before Flop (didn't bet)
Seat 6: b10497f6 collected ($0.05)


Poker Hand #RC211928235: Omaha Pot Limit  ($0.01/$0.02) - 2022/10/21 12:55:36
Table 'RushAndCash1778235' 6-max Seat #1 is the button
Seat 1: c498a10c ($2.23 in chips)
Seat 2: 27602231 ($2.52 in chips)
Seat 3: 1096d828 ($2 in chips)
Seat 4: 309f9058 ($1.48 in chips)
Seat 5: 85e58b19 ($4.15 in chips)
Seat 6: Hero ($2.28 in chips)
27602231: posts small blind $0.01
1096d828: posts big blind $0.02
*** HOLE CARDS ***
Dealt to c498a10c 
Dealt to 27602231 
Dealt to 1096d828 
Dealt to 309f9058 
Dealt to 85e58b19 
Dealt to Hero [Jh 8s Td 7c]
309f9058: raises $0.05 to $0.07
85e58b19: folds
Hero: folds
c498a10c: folds
27602231: folds
1096d828: folds
Uncalled bet ($0.05) returned to 309f9058
*** SHOWDOWN ***
309f9058 collected $0.05 from pot
*** SUMMARY ***
Total pot $0.05 | Rake $0 | Jackpot $0 | Bingo $0
Seat 1: c498a10c (button) folded before Flop (didn't bet)
Seat 2: 27602231 (small blind) folded before Flop
Seat 3: 1096d828 (big blind) folded before Flop
Seat 4: 309f9058 collected ($0.05)
Seat 5: 85e58b19 folded before Flop (didn't bet)
Seat 6: Hero folded before Flop (didn't bet)


Poker Hand #RC211928203: Omaha Pot Limit  ($0.01/$0.02) - 2022/10/21 12:55:21
Table 'RushAndCash1778203' 6-max Seat #1 is the button
Seat 1: a6c42e85 ($1.73 in chips)
Seat 2: f09190e1 ($6.41 in chips)
Seat 3: bc3fa76f ($2.01 in chips)
Seat 4: d3bfa052 ($2.09 in chips)
Seat 5: Hero ($2.25 in chips)
Seat 6: eb8e436f ($1.55 in chips)
f09190e1: posts small blind $0.01
bc3fa76f: posts big blind $0.02
*** HOLE CARDS ***
Dealt to a6c42e85 
Dealt to f09190e1 
Dealt to bc3fa76f 
Dealt to d3bfa052 
Dealt to Hero [Kc 4c Ks Qh]
Dealt to eb8e436f 
d3bfa052: folds
Hero: raises $0.04 to $0.06
eb8e436f: folds
a6c42e85: folds
f09190e1: folds
bc3fa76f: folds
Uncalled bet ($0.04) returned to Hero
*** SHOWDOWN ***
Hero collected $0.05 from pot
*** SUMMARY ***
Total pot $0.05 | Rake $0 | Jackpot $0 | Bingo $0
Seat 1: a6c42e85 (button) folded before Flop (didn't bet)
Seat 2: f09190e1 (small blind) folded before Flop
Seat 3: bc3fa76f (big blind) folded before Flop
Seat 4: d3bfa052 folded before Flop (didn't bet)
Seat 5: Hero collected ($0.05)
Seat 6: eb8e436f folded before Flop (didn't bet)


Poker Hand #RC211928188: Omaha Pot Limit  ($0.01/$0.02) - 2022/10/21 12:55:16
Table 'RushAndCash1778188' 6-max Seat #1 is the button
Seat 1: 691b15b3 ($3.73 in chips)
Seat 2: f2309695 ($3.55 in chips)
Seat 3: 61461a1e ($2.6 in chips)
Seat 4: aa6318f6 ($2.72 in chips)
Seat 5: 223f5e09 ($3.02 in chips)
Seat 6: Hero ($2.25 in chips)
f2309695: posts small blind $0.01
61461a1e: posts big blind $0.02
*** HOLE CARDS ***
Dealt to 691b15b3 
Dealt to f2309695 
Dealt to 61461a1e 
Dealt to aa6318f6 
Dealt to 223f5e09 
Dealt to Hero [2h 3h 9h 2s]
aa6318f6: folds
223f5e09: raises $0.05 to $0.07
Hero: folds
691b15b3: calls $0.07
f2309695: calls $0.06
61461a1e: folds
*** FLOP *** [4d 6s Tc]
f2309695: checks
223f5e09: bets $0.12
691b15b3: calls $0.12
f2309695: calls $0.12
*** TURN *** [4d 6s Tc] [6c]
f2309695: checks
223f5e09: bets $0.2
691b15b3: calls $0.2
f2309695: folds
*** RIVER *** [4d 6s Tc 6c] [5h]
223f5e09: checks
691b15b3: checks
223f5e09: shows [5s Td As Jc] (Pair of Tens and Pair of Sixes)
691b15b3: shows [9c Ac 8c 6d] (Three Sixes)
*** SHOWDOWN ***
691b15b3 collected $0.92 from pot
*** SUMMARY ***
Total pot $0.99 | Rake $0.04 | Jackpot $0.03 | Bingo $0
Board [4d 6s Tc 6c 5h]
Seat 1: 691b15b3 (button) showed [9c Ac 8c 6d] and won ($0.92) with Three Sixes
Seat 2: f2309695 (small blind) folded on the Turn
Seat 3: 61461a1e (big blind) folded before Flop
Seat 4: aa6318f6 folded before Flop (didn't bet)
Seat 5: 223f5e09 showed [5s Td As Jc] and lost with Pair of Tens and Pair of Sixes
Seat 6: Hero folded before Flop (didn't bet)


Poker Hand #RC211928179: Omaha Pot Limit  ($0.01/$0.02) - 2022/10/21 12:55:11
Table 'RushAndCash1778179' 6-max Seat #1 is the button
Seat 1: Hero ($2.25 in chips)
Seat 2: 6bebea35 ($3.3 in chips)
Seat 3: 1a55a ($3.38 in chips)
Seat 4: f52a17e0 ($2.41 in chips)
Seat 5: 7cc03d50 ($3.7 in chips)
Seat 6: 88fd0c1c ($4.31 in chips)
6bebea35: posts small blind $0.01
1a55a: posts big blind $0.02
*** HOLE CARDS ***
Dealt to Hero [Td Qh 3h 4s]
Dealt to 6bebea35 
Dealt to 1a55a 
Dealt to f52a17e0 
Dealt to 7cc03d50 
Dealt to 88fd0c1c 
f52a17e0: folds
7cc03d50: folds
88fd0c1c: folds
Hero: folds
6bebea35: folds
Uncalled bet ($0.01) returned to 1a55a
*** SHOWDOWN ***
1a55a collected $0.02 from pot
*** SUMMARY ***
Total pot $0.02 | Rake $0 | Jackpot $0 | Bingo $0
Seat 1: Hero (button) folded before Flop (didn't bet)
Seat 2: 6bebea35 (small blind) folded before Flop
Seat 3: 1a55a (big blind) collected ($0.02)
Seat 4: f52a17e0 folded before Flop (didn't bet)
Seat 5: 7cc03d50 folded before Flop (didn't bet)
Seat 6: 88fd0c1c folded before Flop (didn't bet)


Poker Hand #RC211928118: Omaha Pot Limit  ($0.01/$0.02) - 2022/10/21 12:54:40
Table 'RushAndCash1778118' 6-max Seat #1 is the button
Seat 1: 7badf949 ($8.1 in chips)
Seat 2: Hero ($2.23 in chips)
Seat 3: 599a53ee ($6.28 in chips)
Seat 4: f2e2bb8f ($4.01 in chips)
Seat 5: 9d0f0d4e ($4.21 in chips)
Seat 6: f254fa50 ($2.23 in chips)
Hero: posts small blind $0.01
599a53ee: posts big blind $0.02
*** HOLE CARDS ***
Dealt to 7badf949 
Dealt to Hero [3s Kc Kh Jd]
Dealt to 599a53ee 
Dealt to f2e2bb8f 
Dealt to 9d0f0d4e 
Dealt to f254fa50 
f2e2bb8f: folds
9d0f0d4e: folds
f254fa50: folds
7badf949: folds
Hero: raises $0.04 to $0.06
599a53ee: folds
Uncalled bet ($0.04) returned to Hero
*** SHOWDOWN ***
Hero collected $0.04 from pot
*** SUMMARY ***
Total pot $0.04 | Rake $0 | Jackpot $0 | Bingo $0
Seat 1: 7badf949 (button) folded before Flop (didn't bet)
Seat 2: Hero (small blind) collected ($0.04)
Seat 3: 599a53ee (big blind) folded before Flop
Seat 4: f2e2bb8f folded before Flop (didn't bet)
Seat 5: 9d0f0d4e folded before Flop (didn't bet)
Seat 6: f254fa50 folded before Flop (didn't bet)


Poker Hand #RC211928106: Omaha Pot Limit  ($0.01/$0.02) - 2022/10/21 12:54:36
Table 'RushAndCash1778106' 6-max Seat #1 is the button
Seat 1: 17c11c29 ($4.73 in chips)
Seat 2: c0930254 ($3.75 in chips)
Seat 3: Hero ($2.25 in chips)
Seat 4: da09ec79 ($2.53 in chips)
Seat 5: 1c49b2d5 ($0.74 in chips)
Seat 6: 12a83aff ($1.76 in chips)
c0930254: posts small blind $0.01
Hero: posts big blind $0.02
*** HOLE CARDS ***
Dealt to 17c11c29 
Dealt to c0930254 
Dealt to Hero [5d Jc Qc 5c]
Dealt to da09ec79 
Dealt to 1c49b2d5 
Dealt to 12a83aff 
da09ec79: raises $0.05 to $0.07
1c49b2d5: folds
12a83aff: folds
17c11c29: folds
c0930254: folds
Hero: folds
Uncalled bet ($0.05) returned to da09ec79
*** SHOWDOWN ***
da09ec79 collected $0.05 from pot
*** SUMMARY ***
Total pot $0.05 | Rake $0 | Jackpot $0 | Bingo $0
Seat 1: 17c11c29 (button) folded before Flop (didn't bet)
Seat 2: c0930254 (small blind) folded before Flop
Seat 3: Hero (big blind) folded before Flop
Seat 4: da09ec79 collected ($0.05)
Seat 5: 1c49b2d5 folded before Flop (didn't bet)
Seat 6: 12a83aff folded before Flop (didn't bet)


Poker Hand #RC211928066: Omaha Pot Limit  ($0.01/$0.02) - 2022/10/21 12:54:15
Table 'RushAndCash1778066' 6-max Seat #1 is the button
Seat 1: dad21c5a ($2.85 in chips)
Seat 2: edef7cdd ($3.3 in chips)
Seat 3: 4ee6356f ($4.91 in chips)
Seat 4: 8796a077 ($4.38 in chips)
Seat 5: c9b9e9c8 ($2.02 in chips)
Seat 6: Hero ($2.25 in chips)
edef7cdd: posts small blind $0.01
4ee6356f: posts big blind $0.02
*** HOLE CARDS ***
Dealt to dad21c5a 
Dealt to edef7cdd 
Dealt to 4ee6356f 
Dealt to 8796a077 
Dealt to c9b9e9c8 
Dealt to Hero [6s Qd Ah Td]
8796a077: raises $0.02 to $0.04
c9b9e9c8: calls $0.04
Hero: folds
dad21c5a: folds
edef7cdd: raises $0.02 to $0.06
4ee6356f: folds
8796a077: calls $0.02
c9b9e9c8: calls $0.02
*** FLOP *** [8d Th 3s]
edef7cdd: checks
8796a077: checks
c9b9e9c8: checks
*** TURN *** [8d Th 3s] [Jh]
edef7cdd: checks
8796a077: bets $0.07
c9b9e9c8: folds
edef7cdd: folds
Uncalled bet ($0.07) returned to 8796a077
*** SHOWDOWN ***
8796a077 collected $0.19 from pot
*** SUMMARY ***
Total pot $0.2 | Rake $0.01 | Jackpot $0 | Bingo $0
Board [8d Th 3s Jh]
Seat 1: dad21c5a (button) folded before Flop (didn't bet)
Seat 2: edef7cdd (small blind) folded on the Turn
Seat 3: 4ee6356f (big blind) folded before Flop
Seat 4: 8796a077 won ($0.19)
Seat 5: c9b9e9c8 folded on the Turn
Seat 6: Hero folded before Flop (didn't bet)


Poker Hand #RC211928053: Omaha Pot Limit  ($0.01/$0.02) - 2022/10/21 12:54:09
Table 'RushAndCash1778053' 6-max Seat #1 is the button
Seat 1: c0e7042c ($1.31 in chips)
Seat 2: 70f7f662 ($10.97 in chips)
Seat 3: f229addc ($5.14 in chips)
Seat 4: d4e135a7 ($2.22 in chips)
Seat 5: a540faeb ($2.3 in chips)
Seat 6: Hero ($2.25 in chips)
70f7f662: posts small blind $0.01
f229addc: posts big blind $0.02
*** HOLE CARDS ***
Dealt to c0e7042c 
Dealt to 70f7f662 
Dealt to f229addc 
Dealt to d4e135a7 
Dealt to a540faeb 
Dealt to Hero [9c 8h Ac 6d]
d4e135a7: folds
a540faeb: raises $0.05 to $0.07
Hero: folds
c0e7042c: folds
70f7f662: folds
f229addc: folds
Uncalled bet ($0.05) returned to a540faeb
*** SHOWDOWN ***
a540faeb collected $0.05 from pot
*** SUMMARY ***
Total pot $0.05 | Rake $0 | Jackpot $0 | Bingo $0
Seat 1: c0e7042c (button) folded before Flop (didn't bet)
Seat 2: 70f7f662 (small blind) folded before Flop
Seat 3: f229addc (big blind) folded before Flop
Seat 4: d4e135a7 folded before Flop (didn't bet)
Seat 5: a540faeb collected ($0.05)
Seat 6: Hero folded before Flop (didn't bet)


Poker Hand #RC211928043: Omaha Pot Limit  ($0.01/$0.02) - 2022/10/21 12:54:04
Table 'RushAndCash1778043' 6-max Seat #1 is the button
Seat 1: a41d747f ($0.52 in chips)
Seat 2: Hero ($2.26 in chips)
Seat 3: f229addc ($5.16 in chips)
Seat 4: ebca57ef ($3.6 in chips)
Seat 5: 27602231 ($2.08 in chips)
Seat 6: 8796a077 ($4.38 in chips)
Hero: posts small blind $0.01
f229addc: posts big blind $0.02
*** HOLE CARDS ***
Dealt to a41d747f 
Dealt to Hero [Kh 9h Qs 2s]
Dealt to f229addc 
Dealt to ebca57ef 
Dealt to 27602231 
Dealt to 8796a077 
ebca57ef: folds
27602231: raises $0.05 to $0.07
8796a077: folds
a41d747f: raises $0.17 to $0.24
Hero: folds
f229addc: folds
27602231: raises $0.51 to $0.75
a41d747f: calls $0.28 and is all-in
Uncalled bet ($0.23) returned to 27602231
27602231: shows [Ac 5d 7s Ah]
a41d747f: shows [6s 2c 5h 4s]
*** FLOP *** [8c Ts Th]
*** TURN *** [8c Ts Th] [6c]
*** RIVER *** [8c Ts Th 6c] [Qh]
*** SHOWDOWN ***
27602231 collected $0.99 from pot
*** SUMMARY ***
Total pot $1.07 | Rake $0.05 | Jackpot $0.03 | Bingo $0
Board [8c Ts Th 6c Qh]
Seat 1: a41d747f (button) showed [6s 2c 5h 4s] and lost with Pair of Tens and Pair of Sixes
Seat 2: Hero (small blind) folded before Flop
Seat 3: f229addc (big blind) folded before Flop
Seat 4: ebca57ef folded before Flop (didn't bet)
Seat 5: 27602231 showed [Ac 5d 7s Ah] and won ($0.99) with Pair of Aces and Pair of Tens
Seat 6: 8796a077 folded before Flop (didn't bet)


Poker Hand #RC211928022: Omaha Pot Limit  ($0.01/$0.02) - 2022/10/21 12:53:55
Table 'RushAndCash1778022' 6-max Seat #1 is the button
Seat 1: 73add92d ($2.87 in chips)
Seat 2: 1e5ff3e ($2 in chips)
Seat 3: 33d39dbc ($2.5 in chips)
Seat 4: f5de8664 ($2.9 in chips)
Seat 5: Hero ($2.26 in chips)
Seat 6: 201d8c95 ($2.02 in chips)
1e5ff3e: posts small blind $0.01
33d39dbc: posts big blind $0.02
*** HOLE CARDS ***
Dealt to 73add92d 
Dealt to 1e5ff3e 
Dealt to 33d39dbc 
Dealt to f5de8664 
Dealt to Hero [2c 9c Ks 3h]
Dealt to 201d8c95 
f5de8664: folds
Hero: folds
201d8c95: folds
73add92d: folds
1e5ff3e: folds
Uncalled bet ($0.01) returned to 33d39dbc
*** SHOWDOWN ***
33d39dbc collected $0.02 from pot
*** SUMMARY ***
Total pot $0.02 | Rake $0 | Jackpot $0 | Bingo $0
Seat 1: 73add92d (button) folded before Flop (didn't bet)
Seat 2: 1e5ff3e (small blind) folded before Flop
Seat 3: 33d39dbc (big blind) collected ($0.02)
Seat 4: f5de8664 folded before Flop (didn't bet)
Seat 5: Hero folded before Flop (didn't bet)
Seat 6: 201d8c95 folded before Flop (didn't bet)


Poker Hand #RC211927947: Omaha Pot Limit  ($0.01/$0.02) - 2022/10/21 12:53:20
Table 'RushAndCash1777947' 6-max Seat #1 is the button
Seat 1: f5de8664 ($2.83 in chips)
Seat 2: 12a83aff ($1.82 in chips)
Seat 3: Hero ($2.32 in chips)
Seat 4: 4cfee7eb ($0.14 in chips)
Seat 5: 1cecdaa3 ($2.84 in chips)
Seat 6: 4065cf4 ($2.71 in chips)
12a83aff: posts small blind $0.01
Hero: posts big blind $0.02
*** HOLE CARDS ***
Dealt to f5de8664 
Dealt to 12a83aff 
Dealt to Hero [7h Ah Js Ks]
Dealt to 4cfee7eb 
Dealt to 1cecdaa3 
Dealt to 4065cf4 
4cfee7eb: folds
1cecdaa3: folds
4065cf4: folds
f5de8664: raises $0.04 to $0.06
12a83aff: folds
Hero: calls $0.04
*** FLOP *** [2d 3c Jc]
Hero: checks
f5de8664: checks
*** TURN *** [2d 3c Jc] [3s]
Hero: checks
f5de8664: bets $0.1
Hero: folds
Uncalled bet ($0.1) returned to f5de8664
*** SHOWDOWN ***
f5de8664 collected $0.13 from pot
*** SUMMARY ***
Total pot $0.13 | Rake $0 | Jackpot $0 | Bingo $0
Board [2d 3c Jc 3s]
Seat 1: f5de8664 (button) won ($0.13)
Seat 2: 12a83aff (small blind) folded before Flop
Seat 3: Hero (big blind) folded on the Turn
Seat 4: 4cfee7eb folded before Flop (didn't bet)
Seat 5: 1cecdaa3 folded before Flop (didn't bet)
Seat 6: 4065cf4 folded before Flop (didn't bet)


Poker Hand #RC211927940: Omaha Pot Limit  ($0.01/$0.02) - 2022/10/21 12:53:17
Table 'RushAndCash1777940' 6-max Seat #1 is the button
Seat 1: Hero ($2.32 in chips)
Seat 2: 21246ec4 ($2.52 in chips)
Seat 3: 309f9058 ($1.31 in chips)
Seat 4: d27dca65 ($2.02 in chips)
Seat 5: 17c11c29 ($4.82 in chips)
Seat 6: 5332240a ($2.06 in chips)
21246ec4: posts small blind $0.01
309f9058: posts big blind $0.02
*** HOLE CARDS ***
Dealt to Hero [2c 6c Kc 4h]
Dealt to 21246ec4 
Dealt to 309f9058 
Dealt to d27dca65 
Dealt to 17c11c29 
Dealt to 5332240a 
d27dca65: calls $0.02
17c11c29: folds
5332240a: folds
Hero: folds
21246ec4: folds
309f9058: checks
*** FLOP *** [Qs 7s Ah]
309f9058: checks
d27dca65: checks
*** TURN *** [Qs 7s Ah] [Js]
309f9058: checks
d27dca65: bets $0.05
309f9058: folds
Uncalled bet ($0.05) returned to d27dca65
*** SHOWDOWN ***
d27dca65 collected $0.05 from pot
*** SUMMARY ***
Total pot $0.05 | Rake $0 | Jackpot $0 | Bingo $0
Board [Qs 7s Ah Js]
Seat 1: Hero (button) folded before Flop (didn't bet)
Seat 2: 21246ec4 (small blind) folded before Flop
Seat 3: 309f9058 (big blind) folded on the Turn
Seat 4: d27dca65 won ($0.05)
Seat 5: 17c11c29 folded before Flop (didn't bet)
Seat 6: 5332240a folded before Flop (didn't bet)


Poker Hand #RC211927933: Omaha Pot Limit  ($0.01/$0.02) - 2022/10/21 12:53:13
Table 'RushAndCash1777933' 6-max Seat #1 is the button
Seat 1: 21246ec4 ($2.52 in chips)
Seat 2: db2c3e63 ($2.55 in chips)
Seat 3: fe0e0c53 ($2.93 in chips)
Seat 4: Hero ($2.32 in chips)
Seat 5: 839711cf ($2 in chips)
Seat 6: 17eabed ($4.86 in chips)
db2c3e63: posts small blind $0.01
fe0e0c53: posts big blind $0.02
*** HOLE CARDS ***
Dealt to 21246ec4 
Dealt to db2c3e63 
Dealt to fe0e0c53 
Dealt to Hero [Qc Jc Kc 8h]
Dealt to 839711cf 
Dealt to 17eabed 
Hero: folds
839711cf: folds
17eabed: raises $0.02 to $0.04
21246ec4: folds
db2c3e63: folds
fe0e0c53: calls $0.02
*** FLOP *** [Td 3c 6h]
fe0e0c53: checks
17eabed: checks
*** TURN *** [Td 3c 6h] [5d]
fe0e0c53: bets $0.09
17eabed: calls $0.09
*** RIVER *** [Td 3c 6h 5d] [2h]
fe0e0c53: bets $0.27
17eabed: raises $0.81 to $1.08
fe0e0c53: folds
Uncalled bet ($0.81) returned to 17eabed
*** SHOWDOWN ***
17eabed collected $0.75 from pot
*** SUMMARY ***
Total pot $0.81 | Rake $0.03 | Jackpot $0.03 | Bingo $0
Board [Td 3c 6h 5d 2h]
Seat 1: 21246ec4 (button) folded before Flop (didn't bet)
Seat 2: db2c3e63 (small blind) folded before Flop
Seat 3: fe0e0c53 (big blind) folded on the River
Seat 4: Hero folded before Flop (didn't bet)
Seat 5: 839711cf folded before Flop (didn't bet)
Seat 6: 17eabed won ($0.75)


Poker Hand #RC211927923: Omaha Pot Limit  ($0.01/$0.02) - 2022/10/21 12:53:07
Table 'RushAndCash1777923' 6-max Seat #1 is the button
Seat 1: a6c42e85 ($1.61 in chips)
Seat 2: aa6318f6 ($2.2 in chips)
Seat 3: 61b92208 ($24 in chips)
Seat 4: c78ac035 ($1.31 in chips)
Seat 5: Hero ($2.32 in chips)
Seat 6: 17c11c29 ($4.82 in chips)
aa6318f6: posts small blind $0.01
61b92208: posts big blind $0.02
*** HOLE CARDS ***
Dealt to a6c42e85 
Dealt to aa6318f6 
Dealt to 61b92208 
Dealt to c78ac035 
Dealt to Hero [6d Qs Tc Th]
Dealt to 17c11c29 
c78ac035: raises $0.02 to $0.04
Hero: folds
17c11c29: folds
a6c42e85: folds
aa6318f6: raises $0.1 to $0.14
61b92208: folds
c78ac035: calls $0.1
*** FLOP *** [3d 3c Ah]
aa6318f6: bets $0.23
c78ac035: folds
Uncalled bet ($0.23) returned to aa6318f6
*** SHOWDOWN ***
aa6318f6 collected $0.29 from pot
*** SUMMARY ***
Total pot $0.3 | Rake $0.01 | Jackpot $0 | Bingo $0
Board [3d 3c Ah]
Seat 1: a6c42e85 (button) folded before Flop (didn't bet)
Seat 2: aa6318f6 (small blind) won ($0.29)
Seat 3: 61b92208 (big blind) folded before Flop
Seat 4: c78ac035 folded on the Flop
Seat 5: Hero folded before Flop (didn't bet)
Seat 6: 17c11c29 folded before Flop (didn't bet)


Poker Hand #RC211927832: Omaha Pot Limit  ($0.01/$0.02) - 2022/10/21 12:52:18
Table 'RushAndCash1777832' 6-max Seat #1 is the button
Seat 1: b6ccb754 ($1.38 in chips)
Seat 2: 55313f6b ($1.45 in chips)
Seat 3: Hero ($2.14 in chips)
Seat 4: 5a1b8c82 ($2 in chips)
Seat 5: 4cfee7eb ($0.21 in chips)
Seat 6: c78ac035 ($1.5 in chips)
55313f6b: posts small blind $0.01
Hero: posts big blind $0.02
*** HOLE CARDS ***
Dealt to b6ccb754 
Dealt to 55313f6b 
Dealt to Hero [9d 2h Jh Ad]
Dealt to 5a1b8c82 
Dealt to 4cfee7eb 
Dealt to c78ac035 
5a1b8c82: folds
4cfee7eb: folds
c78ac035: raises $0.02 to $0.04
b6ccb754: folds
55313f6b: folds
Hero: calls $0.02
*** FLOP *** [6c 2c Jd]
Hero: checks
c78ac035: bets $0.05
Hero: calls $0.05
*** TURN *** [6c 2c Jd] [5d]
Hero: checks
c78ac035: checks
*** RIVER *** [6c 2c Jd 5d] [Qh]
Hero: checks
c78ac035: bets $0.1
Hero: calls $0.1
c78ac035: shows [Qc 9c Kd Tc] (Pair of Queens)
Hero: shows [9d 2h Jh Ad] (Pair of Jacks and Pair of Twos)
*** SHOWDOWN ***
Hero collected $0.37 from pot
*** SUMMARY ***
Total pot $0.39 | Rake $0.02 | Jackpot $0 | Bingo $0
Board [6c 2c Jd 5d Qh]
Seat 1: b6ccb754 (button) folded before Flop (didn't bet)
Seat 2: 55313f6b (small blind) folded before Flop
Seat 3: Hero (big blind) showed [9d 2h Jh Ad] and won ($0.37) with Pair of Jacks and Pair of Twos
Seat 4: 5a1b8c82 folded before Flop (didn't bet)
Seat 5: 4cfee7eb folded before Flop (didn't bet)
Seat 6: c78ac035 showed [Qc 9c Kd Tc] and lost with Pair of Queens


Poker Hand #RC211927688: Omaha Pot Limit  ($0.01/$0.02) - 2022/10/21 12:51:13
Table 'RushAndCash1777688' 6-max Seat #1 is the button
Seat 1: Hero ($2.15 in chips)
Seat 2: c78ac035 ($1.39 in chips)
Seat 3: 7143dcd ($2 in chips)
Seat 4: c10a0fbc ($6.34 in chips)
Seat 5: f5524b6e ($3.06 in chips)
Seat 6: 55313f6b ($1.45 in chips)
c78ac035: posts small blind $0.01
7143dcd: posts big blind $0.02
*** HOLE CARDS ***
Dealt to Hero [Ac Kd Ts 2d]
Dealt to c78ac035 
Dealt to 7143dcd 
Dealt to c10a0fbc 
Dealt to f5524b6e 
Dealt to 55313f6b 
c10a0fbc: folds
f5524b6e: folds
55313f6b: raises $0.05 to $0.07
Hero: calls $0.07
c78ac035: folds
7143dcd: calls $0.05
*** FLOP *** [7d Qd 5s]
7143dcd: checks
55313f6b: bets $0.22
Hero: calls $0.22
7143dcd: folds
*** TURN *** [7d Qd 5s] [Th]
55313f6b: bets $0.66
Hero: raises $1.2 to $1.86 and is all-in
55313f6b: calls $0.5 and is all-in
Uncalled bet ($0.7) returned to Hero
Hero: shows [Ac Kd Ts 2d] (Pair of Tens)
55313f6b: shows [Qh Ah Kh As] (Pair of Aces)
*** FIRST RIVER *** [7d Qd 5s Th] [5d]
*** SECOND RIVER *** [7d Qd 5s Th] [5h]
*** FIRST SHOWDOWN ***
Hero collected $1.44 from pot
*** SECOND SHOWDOWN ***
55313f6b collected $1.45 from pot
*** SUMMARY ***
Total pot $2.98 | Rake $0.06 | Jackpot $0.03 | Bingo $0
Hand was run two times
FIRST Board [7d Qd 5s Th 5d]
SECOND Board [5h]
Seat 1: Hero (button) showed [Ac Kd Ts 2d] and won ($1.44) with King High Flush, and lost with Ace-High
Seat 2: c78ac035 (small blind) folded before Flop
Seat 3: 7143dcd (big blind) folded on the Flop
Seat 4: c10a0fbc folded before Flop (didn't bet)
Seat 5: f5524b6e folded before Flop (didn't bet)
Seat 6: 55313f6b showed [Qh Ah Kh As] and lost with Pair of Aces and Pair of Fives, and won ($1.45) with Pair of Aces


Poker Hand #RC211927678: Omaha Pot Limit  ($0.01/$0.02) - 2022/10/21 12:51:09
Table 'RushAndCash1777678' 6-max Seat #1 is the button
Seat 1: 6ef50542 ($5.03 in chips)
Seat 2: 47700101 ($2.62 in chips)
Seat 3: 582a77b7 ($6.02 in chips)
Seat 4: 5e6429a2 ($1.79 in chips)
Seat 5: f5524b6e ($3.06 in chips)
Seat 6: Hero ($2.15 in chips)
47700101: posts small blind $0.01
582a77b7: posts big blind $0.02
*** HOLE CARDS ***
Dealt to 6ef50542 
Dealt to 47700101 
Dealt to 582a77b7 
Dealt to 5e6429a2 
Dealt to f5524b6e 
Dealt to Hero [4c 3h Jh 5s]
5e6429a2: raises $0.05 to $0.07
f5524b6e: folds
Hero: folds
6ef50542: folds
47700101: folds
582a77b7: calls $0.05
*** FLOP *** [8d 6h Th]
582a77b7: checks
5e6429a2: bets $0.15
582a77b7: calls $0.15
*** TURN *** [8d 6h Th] [Kd]
582a77b7: checks
5e6429a2: bets $0.32
582a77b7: raises $1.09 to $1.41
5e6429a2: folds
Uncalled bet ($1.09) returned to 582a77b7
*** SHOWDOWN ***
582a77b7 collected $1.01 from pot
*** SUMMARY ***
Total pot $1.09 | Rake $0.05 | Jackpot $0.03 | Bingo $0
Board [8d 6h Th Kd]
Seat 1: 6ef50542 (button) folded before Flop (didn't bet)
Seat 2: 47700101 (small blind) folded before Flop
Seat 3: 582a77b7 (big blind) won ($1.01)
Seat 4: 5e6429a2 folded on the Turn
Seat 5: f5524b6e folded before Flop (didn't bet)
Seat 6: Hero folded before Flop (didn't bet)


Poker Hand #RC211927637: Omaha Pot Limit  ($0.01/$0.02) - 2022/10/21 12:50:53
Table 'RushAndCash1777637' 6-max Seat #1 is the button
Seat 1: 4065cf4 ($3.52 in chips)
Seat 2: 86010f0f ($7.01 in chips)
Seat 3: a97e602d ($2.45 in chips)
Seat 4: Hero ($2.21 in chips)
Seat 5: 1962c895 ($1.43 in chips)
Seat 6: 9415f42a ($2.01 in chips)
86010f0f: posts small blind $0.01
a97e602d: posts big blind $0.02
*** HOLE CARDS ***
Dealt to 4065cf4 
Dealt to 86010f0f 
Dealt to a97e602d 
Dealt to Hero [5d Ad 7s 7h]
Dealt to 1962c895 
Dealt to 9415f42a 
Hero: raises $0.04 to $0.06
1962c895: folds
9415f42a: folds
4065cf4: raises $0.15 to $0.21
86010f0f: folds
a97e602d: folds
Hero: folds
Uncalled bet ($0.15) returned to 4065cf4
*** SHOWDOWN ***
4065cf4 collected $0.15 from pot
*** SUMMARY ***
Total pot $0.15 | Rake $0 | Jackpot $0 | Bingo $0
Seat 1: 4065cf4 (button) collected ($0.15)
Seat 2: 86010f0f (small blind) folded before Flop
Seat 3: a97e602d (big blind) folded before Flop
Seat 4: Hero folded before Flop
Seat 5: 1962c895 folded before Flop (didn't bet)
Seat 6: 9415f42a folded before Flop (didn't bet)


Poker Hand #RC211927628: Omaha Pot Limit  ($0.01/$0.02) - 2022/10/21 12:50:49
Table 'RushAndCash1777628' 6-max Seat #1 is the button
Seat 1: 1962c895 ($1.43 in chips)
Seat 2: b6ccb754 ($1.34 in chips)
Seat 3: 41d0b6cd ($1.01 in chips)
Seat 4: 80ddfc8 ($2.05 in chips)
Seat 5: Hero ($2.21 in chips)
Seat 6: 239958fb ($4.34 in chips)
b6ccb754: posts small blind $0.01
41d0b6cd: posts big blind $0.02
*** HOLE CARDS ***
Dealt to 1962c895 
Dealt to b6ccb754 
Dealt to 41d0b6cd 
Dealt to 80ddfc8 
Dealt to Hero [Ks 6d 4s Th]
Dealt to 239958fb 
80ddfc8: folds
Hero: folds
239958fb: folds
1962c895: folds
b6ccb754: raises $0.04 to $0.06
41d0b6cd: calls $0.04
*** FLOP *** [9s 8d 9h]
b6ccb754: bets $0.04
41d0b6cd: folds
Uncalled bet ($0.04) returned to b6ccb754
*** SHOWDOWN ***
b6ccb754 collected $0.12 from pot
*** SUMMARY ***
Total pot $0.12 | Rake $0 | Jackpot $0 | Bingo $0
Board [9s 8d 9h]
Seat 1: 1962c895 (button) folded before Flop (didn't bet)
Seat 2: b6ccb754 (small blind) won ($0.12)
Seat 3: 41d0b6cd (big blind) folded on the Flop
Seat 4: 80ddfc8 folded before Flop (didn't bet)
Seat 5: Hero folded before Flop (didn't bet)
Seat 6: 239958fb folded before Flop (didn't bet)


Poker Hand #RC211927501: Omaha Pot Limit  ($0.01/$0.02) - 2022/10/21 12:49:54
Table 'RushAndCash1777501' 6-max Seat #1 is the button
Seat 1: 9d0f0d4e ($2.49 in chips)
Seat 2: d15cfab0 ($2 in chips)
Seat 3: 275f292b ($0.77 in chips)
Seat 4: 792e227 ($13.22 in chips)
Seat 5: 95a39865 ($8.77 in chips)
Seat 6: Hero ($1.78 in chips)
d15cfab0: posts small blind $0.01
275f292b: posts big blind $0.02
*** HOLE CARDS ***
Dealt to 9d0f0d4e 
Dealt to d15cfab0 
Dealt to 275f292b 
Dealt to 792e227 
Dealt to 95a39865 
Dealt to Hero [Ad Ac 4c 5s]
792e227: raises $0.05 to $0.07
95a39865: folds
Hero: raises $0.17 to $0.24
9d0f0d4e: folds
d15cfab0: folds
275f292b: calls $0.22
792e227: calls $0.17
*** FLOP *** [Ts Tc 3d]
275f292b: checks
792e227: checks
Hero: bets $0.73
275f292b: folds
792e227: folds
Uncalled bet ($0.73) returned to Hero
*** SHOWDOWN ***
Hero collected $0.67 from pot
*** SUMMARY ***
Total pot $0.73 | Rake $0.03 | Jackpot $0.03 | Bingo $0
Board [Ts Tc 3d]
Seat 1: 9d0f0d4e (button) folded before Flop (didn't bet)
Seat 2: d15cfab0 (small blind) folded before Flop
Seat 3: 275f292b (big blind) folded on the Flop
Seat 4: 792e227 folded on the Flop
Seat 5: 95a39865 folded before Flop (didn't bet)
Seat 6: Hero won ($0.67)


Poker Hand #RC211927409: Omaha Pot Limit  ($0.01/$0.02) - 2022/10/21 12:49:15
Table 'RushAndCash1777409' 6-max Seat #1 is the button
Seat 1: b7078c97 ($1.79 in chips)
Seat 2: Hero ($1.85 in chips)
Seat 3: 95a39865 ($8.7 in chips)
Seat 4: 9d0f0d4e ($2.52 in chips)
Seat 5: b37829b7 ($2.03 in chips)
Seat 6: c3f56515 ($2 in chips)
Hero: posts small blind $0.01
95a39865: posts big blind $0.02
*** HOLE CARDS ***
Dealt to b7078c97 
Dealt to Hero [Ah 3s 3h 8d]
Dealt to 95a39865 
Dealt to 9d0f0d4e 
Dealt to b37829b7 
Dealt to c3f56515 
9d0f0d4e: folds
b37829b7: folds
c3f56515: folds
b7078c97: folds
Hero: raises $0.02 to $0.04
95a39865: calls $0.02
*** FLOP *** [7d Qc Th]
Hero: bets $0.03
95a39865: calls $0.03
*** TURN *** [7d Qc Th] [6c]
Hero: checks
95a39865: bets $0.11
Hero: folds
Uncalled bet ($0.11) returned to 95a39865
*** SHOWDOWN ***
95a39865 collected $0.14 from pot
*** SUMMARY ***
Total pot $0.14 | Rake $0 | Jackpot $0 | Bingo $0
Board [7d Qc Th 6c]
Seat 1: b7078c97 (button) folded before Flop (didn't bet)
Seat 2: Hero (small blind) folded on the Turn
Seat 3: 95a39865 (big blind) won ($0.14)
Seat 4: 9d0f0d4e folded before Flop (didn't bet)
Seat 5: b37829b7 folded before Flop (didn't bet)
Seat 6: c3f56515 folded before Flop (didn't bet)


Poker Hand #RC211927395: Omaha Pot Limit  ($0.01/$0.02) - 2022/10/21 12:49:09
Table 'RushAndCash1777395' 6-max Seat #1 is the button
Seat 1: 239958fb ($4.34 in chips)
Seat 2: 799f4168 ($2 in chips)
Seat 3: 75402b95 ($4.16 in chips)
Seat 4: Hero ($1.85 in chips)
Seat 5: 419bbbaf ($2.2 in chips)
Seat 6: 78b3c286 ($1.59 in chips)
799f4168: posts small blind $0.01
75402b95: posts big blind $0.02
*** HOLE CARDS ***
Dealt to 239958fb 
Dealt to 799f4168 
Dealt to 75402b95 
Dealt to Hero [9h Kd 2s 9s]
Dealt to 419bbbaf 
Dealt to 78b3c286 
Hero: folds
419bbbaf: folds
78b3c286: folds
239958fb: folds
799f4168: folds
Uncalled bet ($0.01) returned to 75402b95
*** SHOWDOWN ***
75402b95 collected $0.02 from pot
*** SUMMARY ***
Total pot $0.02 | Rake $0 | Jackpot $0 | Bingo $0
Seat 1: 239958fb (button) folded before Flop (didn't bet)
Seat 2: 799f4168 (small blind) folded before Flop
Seat 3: 75402b95 (big blind) collected ($0.02)
Seat 4: Hero folded before Flop (didn't bet)
Seat 5: 419bbbaf folded before Flop (didn't bet)
Seat 6: 78b3c286 folded before Flop (didn't bet)


Poker Hand #RC211927387: Omaha Pot Limit  ($0.01/$0.02) - 2022/10/21 12:49:05
Table 'RushAndCash1777387' 6-max Seat #1 is the button
Seat 1: caa49113 ($2.04 in chips)
Seat 2: Hero ($1.86 in chips)
Seat 3: 3f529b9c ($0.44 in chips)
Seat 4: 92c2068a ($1.9 in chips)
Seat 5: da09ec79 ($2.06 in chips)
Seat 6: 75402b95 ($4.16 in chips)
Hero: posts small blind $0.01
3f529b9c: posts big blind $0.02
*** HOLE CARDS ***
Dealt to caa49113 
Dealt to Hero [As 6d 8c Kc]
Dealt to 3f529b9c 
Dealt to 92c2068a 
Dealt to da09ec79 
Dealt to 75402b95 
92c2068a: folds
da09ec79: folds
75402b95: folds
caa49113: raises $0.05 to $0.07
Hero: folds
3f529b9c: calls $0.05
*** FLOP *** [4s 2c Td]
3f529b9c: bets $0.12
caa49113: folds
Uncalled bet ($0.12) returned to 3f529b9c
*** SHOWDOWN ***
3f529b9c collected $0.15 from pot
*** SUMMARY ***
Total pot $0.15 | Rake $0 | Jackpot $0 | Bingo $0
Board [4s 2c Td]
Seat 1: caa49113 (button) folded on the Flop
Seat 2: Hero (small blind) folded before Flop
Seat 3: 3f529b9c (big blind) won ($0.15)
Seat 4: 92c2068a folded before Flop (didn't bet)
Seat 5: da09ec79 folded before Flop (didn't bet)
Seat 6: 75402b95 folded before Flop (didn't bet)


Poker Hand #RC211927379: Omaha Pot Limit  ($0.01/$0.02) - 2022/10/21 12:49:02
Table 'RushAndCash1777379' 6-max Seat #1 is the button
Seat 1: 60c62cbf ($4.92 in chips)
Seat 2: 9b781057 ($2.34 in chips)
Seat 3: 5427bc9d ($1.85 in chips)
Seat 4: 5255aa86 ($2.49 in chips)
Seat 5: be829150 ($2.02 in chips)
Seat 6: Hero ($1.86 in chips)
9b781057: posts small blind $0.01
5427bc9d: posts big blind $0.02
*** HOLE CARDS ***
Dealt to 60c62cbf 
Dealt to 9b781057 
Dealt to 5427bc9d 
Dealt to 5255aa86 
Dealt to be829150 
Dealt to Hero [7h Qc Js Ts]
5255aa86: folds
be829150: folds
Hero: folds
60c62cbf: folds
9b781057: folds
Uncalled bet ($0.01) returned to 5427bc9d
*** SHOWDOWN ***
5427bc9d collected $0.02 from pot
*** SUMMARY ***
Total pot $0.02 | Rake $0 | Jackpot $0 | Bingo $0
Seat 1: 60c62cbf (button) folded before Flop (didn't bet)
Seat 2: 9b781057 (small blind) folded before Flop
Seat 3: 5427bc9d (big blind) collected ($0.02)
Seat 4: 5255aa86 folded before Flop (didn't bet)
Seat 5: be829150 folded before Flop (didn't bet)
Seat 6: Hero folded before Flop (didn't bet)


Poker Hand #RC211927370: Omaha Pot Limit  ($0.01/$0.02) - 2022/10/21 12:48:58
Table 'RushAndCash1777370' 6-max Seat #1 is the button
Seat 1: 4012dcfa ($1.11 in chips)
Seat 2: 60c62cbf ($4.93 in chips)
Seat 3: Hero ($1.88 in chips)
Seat 4: 61461a1e ($3.48 in chips)
Seat 5: 2898300f ($6.3 in chips)
Seat 6: 1e9ff1cd ($2.97 in chips)
60c62cbf: posts small blind $0.01
Hero: posts big blind $0.02
*** HOLE CARDS ***
Dealt to 4012dcfa 
Dealt to 60c62cbf 
Dealt to Hero [7s Qc 2s 2d]
Dealt to 61461a1e 
Dealt to 2898300f 
Dealt to 1e9ff1cd 
61461a1e: folds
2898300f: folds
1e9ff1cd: raises $0.03 to $0.05
4012dcfa: folds
60c62cbf: folds
Hero: folds
Uncalled bet ($0.03) returned to 1e9ff1cd
*** SHOWDOWN ***
1e9ff1cd collected $0.05 from pot
*** SUMMARY ***
Total pot $0.05 | Rake $0 | Jackpot $0 | Bingo $0
Seat 1: 4012dcfa (button) folded before Flop (didn't bet)
Seat 2: 60c62cbf (small blind) folded before Flop
Seat 3: Hero (big blind) folded before Flop
Seat 4: 61461a1e folded before Flop (didn't bet)
Seat 5: 2898300f folded before Flop (didn't bet)
Seat 6: 1e9ff1cd collected ($0.05)


Poker Hand #RC211927361: Omaha Pot Limit  ($0.01/$0.02) - 2022/10/21 12:48:55
Table 'RushAndCash1777361' 6-max Seat #1 is the button
Seat 1: 7a63c988 ($2 in chips)
Seat 2: 1cecdaa3 ($2.62 in chips)
Seat 3: 7cc03d50 ($2.9 in chips)
Seat 4: Hero ($1.88 in chips)
Seat 5: 1a55a ($4.08 in chips)
Seat 6: 4ee6356f ($2.86 in chips)
1cecdaa3: posts small blind $0.01
7cc03d50: posts big blind $0.02
*** HOLE CARDS ***
Dealt to 7a63c988 
Dealt to 1cecdaa3 
Dealt to 7cc03d50 
Dealt to Hero [6c Ah Ts 3h]
Dealt to 1a55a 
Dealt to 4ee6356f 
Hero: folds
1a55a: folds
4ee6356f: folds
7a63c988: raises $0.03 to $0.05
1cecdaa3: folds
7cc03d50: folds
Uncalled bet ($0.03) returned to 7a63c988
*** SHOWDOWN ***
7a63c988 collected $0.05 from pot
*** SUMMARY ***
Total pot $0.05 | Rake $0 | Jackpot $0 | Bingo $0
Seat 1: 7a63c988 (button) collected ($0.05)
Seat 2: 1cecdaa3 (small blind) folded before Flop
Seat 3: 7cc03d50 (big blind) folded before Flop
Seat 4: Hero folded before Flop (didn't bet)
Seat 5: 1a55a folded before Flop (didn't bet)
Seat 6: 4ee6356f folded before Flop (didn't bet)


Poker Hand #RC211927341: Omaha Pot Limit  ($0.01/$0.02) - 2022/10/21 12:48:45
Table 'RushAndCash1777341' 6-max Seat #1 is the button
Seat 1: b415edae ($2 in chips)
Seat 2: f229addc ($6.97 in chips)
Seat 3: 55386e9f ($2 in chips)
Seat 4: Hero ($1.88 in chips)
Seat 5: cfbaf2a9 ($9.66 in chips)
Seat 6: 71c24ec5 ($7.4 in chips)
f229addc: posts small blind $0.01
55386e9f: posts big blind $0.02
*** HOLE CARDS ***
Dealt to b415edae 
Dealt to f229addc 
Dealt to 55386e9f 
Dealt to Hero [Tc 8d Kd 9d]
Dealt to cfbaf2a9 
Dealt to 71c24ec5 
Hero: folds
cfbaf2a9: folds
71c24ec5: folds
b415edae: folds
f229addc: folds
Uncalled bet ($0.01) returned to 55386e9f
*** SHOWDOWN ***
55386e9f collected $0.02 from pot
*** SUMMARY ***
Total pot $0.02 | Rake $0 | Jackpot $0 | Bingo $0
Seat 1: b415edae (button) folded before Flop (didn't bet)
Seat 2: f229addc (small blind) folded before Flop
Seat 3: 55386e9f (big blind) collected ($0.02)
Seat 4: Hero folded before Flop (didn't bet)
Seat 5: cfbaf2a9 folded before Flop (didn't bet)
Seat 6: 71c24ec5 folded before Flop (didn't bet)


Poker Hand #RC211927332: Omaha Pot Limit  ($0.01/$0.02) - 2022/10/21 12:48:40
Table 'RushAndCash1777332' 6-max Seat #1 is the button
Seat 1: Hero ($1.88 in chips)
Seat 2: cdc6c025 ($8.8 in chips)
Seat 3: 5537777d ($3.56 in chips)
Seat 4: 4cc4e7f3 ($3.03 in chips)
Seat 5: 71c24ec5 ($7.4 in chips)
Seat 6: 38ddecaa ($0.96 in chips)
cdc6c025: posts small blind $0.01
5537777d: posts big blind $0.02
*** HOLE CARDS ***
Dealt to Hero [2h 4c 8c 9s]
Dealt to cdc6c025 
Dealt to 5537777d 
Dealt to 4cc4e7f3 
Dealt to 71c24ec5 
Dealt to 38ddecaa 
4cc4e7f3: folds
71c24ec5: folds
38ddecaa: raises $0.02 to $0.04
Hero: folds
cdc6c025: raises $0.1 to $0.14
5537777d: folds
38ddecaa: calls $0.1
*** FLOP *** [7d 5c 4s]
cdc6c025: bets $0.3
38ddecaa: folds
Uncalled bet ($0.3) returned to cdc6c025
*** SHOWDOWN ***
cdc6c025 collected $0.29 from pot
*** SUMMARY ***
Total pot $0.3 | Rake $0.01 | Jackpot $0 | Bingo $0
Board [7d 5c 4s]
Seat 1: Hero (button) folded before Flop (didn't bet)
Seat 2: cdc6c025 (small blind) won ($0.29)
Seat 3: 5537777d (big blind) folded before Flop
Seat 4: 4cc4e7f3 folded before Flop (didn't bet)
Seat 5: 71c24ec5 folded before Flop (didn't bet)
Seat 6: 38ddecaa folded on the Flop


Poker Hand #RC211927325: Omaha Pot Limit  ($0.01/$0.02) - 2022/10/21 12:48:36
Table 'RushAndCash1777325' 6-max Seat #1 is the button
Seat 1: aa989090 ($2.54 in chips)
Seat 2: Hero ($1.89 in chips)
Seat 3: 582a77b7 ($6.01 in chips)
Seat 4: b7078c97 ($1.79 in chips)
Seat 5: f229addc ($6.97 in chips)
Seat 6: d3e1cc8f ($2 in chips)
Hero: posts small blind $0.01
582a77b7: posts big blind $0.02
*** HOLE CARDS ***
Dealt to aa989090 
Dealt to Hero [5h Qd 7s 4c]
Dealt to 582a77b7 
Dealt to b7078c97 
Dealt to f229addc 
Dealt to d3e1cc8f 
b7078c97: raises $0.05 to $0.07
f229addc: folds
d3e1cc8f: folds
aa989090: folds
Hero: folds
582a77b7: folds
Uncalled bet ($0.05) returned to b7078c97
*** SHOWDOWN ***
b7078c97 collected $0.05 from pot
*** SUMMARY ***
Total pot $0.05 | Rake $0 | Jackpot $0 | Bingo $0
Seat 1: aa989090 (button) folded before Flop (didn't bet)
Seat 2: Hero (small blind) folded before Flop
Seat 3: 582a77b7 (big blind) folded before Flop
Seat 4: b7078c97 collected ($0.05)
Seat 5: f229addc folded before Flop (didn't bet)
Seat 6: d3e1cc8f folded before Flop (didn't bet)


Poker Hand #RC211927319: Omaha Pot Limit  ($0.01/$0.02) - 2022/10/21 12:48:32
Table 'RushAndCash1777319' 6-max Seat #1 is the button
Seat 1: 5f9f0099 ($7.09 in chips)
Seat 2: 5255aa86 ($2.52 in chips)
Seat 3: Hero ($1.91 in chips)
Seat 4: eca793f6 ($0.93 in chips)
Seat 5: 691b15b3 ($2.88 in chips)
Seat 6: de764959 ($3.25 in chips)
5255aa86: posts small blind $0.01
Hero: posts big blind $0.02
*** HOLE CARDS ***
Dealt to 5f9f0099 
Dealt to 5255aa86 
Dealt to Hero [6h 8d Ad 8h]
Dealt to eca793f6 
Dealt to 691b15b3 
Dealt to de764959 
eca793f6: folds
691b15b3: raises $0.05 to $0.07
de764959: folds
5f9f0099: folds
5255aa86: folds
Hero: folds
Uncalled bet ($0.05) returned to 691b15b3
*** SHOWDOWN ***
691b15b3 collected $0.05 from pot
*** SUMMARY ***
Total pot $0.05 | Rake $0 | Jackpot $0 | Bingo $0
Seat 1: 5f9f0099 (button) folded before Flop (didn't bet)
Seat 2: 5255aa86 (small blind) folded before Flop
Seat 3: Hero (big blind) folded before Flop
Seat 4: eca793f6 folded before Flop (didn't bet)
Seat 5: 691b15b3 collected ($0.05)
Seat 6: de764959 folded before Flop (didn't bet)


Poker Hand #RC211927289: Omaha Pot Limit  ($0.01/$0.02) - 2022/10/21 12:48:18
Table 'RushAndCash1777289' 6-max Seat #1 is the button
Seat 1: Hero ($1.91 in chips)
Seat 2: cfbaf2a9 ($9.66 in chips)
Seat 3: f5de8664 ($2.97 in chips)
Seat 4: f295722e ($8.7 in chips)
Seat 5: 80892a00 ($10.59 in chips)
Seat 6: 86010f0f ($7.14 in chips)
cfbaf2a9: posts small blind $0.01
f5de8664: posts big blind $0.02
*** HOLE CARDS ***
Dealt to Hero [Qc 8d 5h 4d]
Dealt to cfbaf2a9 
Dealt to f5de8664 
Dealt to f295722e 
Dealt to 80892a00 
Dealt to 86010f0f 
f295722e: raises $0.04 to $0.06
80892a00: folds
86010f0f: folds
Hero: folds
cfbaf2a9: folds
f5de8664: folds
Uncalled bet ($0.04) returned to f295722e
*** SHOWDOWN ***
f295722e collected $0.05 from pot
*** SUMMARY ***
Total pot $0.05 | Rake $0 | Jackpot $0 | Bingo $0
Seat 1: Hero (button) folded before Flop (didn't bet)
Seat 2: cfbaf2a9 (small blind) folded before Flop
Seat 3: f5de8664 (big blind) folded before Flop
Seat 4: f295722e collected ($0.05)
Seat 5: 80892a00 folded before Flop (didn't bet)
Seat 6: 86010f0f folded before Flop (didn't bet)


Poker Hand #RC211927283: Omaha Pot Limit  ($0.01/$0.02) - 2022/10/21 12:48:14
Table 'RushAndCash1777283' 6-max Seat #1 is the button
Seat 1: 4ba923ea ($2.05 in chips)
Seat 2: ec497a2f ($2.2 in chips)
Seat 3: 80892a00 ($10.61 in chips)
Seat 4: Hero ($1.91 in chips)
Seat 5: dad21c5a ($2.39 in chips)
Seat 6: 5c436c3 ($2.08 in chips)
ec497a2f: posts small blind $0.01
80892a00: posts big blind $0.02
*** HOLE CARDS ***
Dealt to 4ba923ea 
Dealt to ec497a2f 
Dealt to 80892a00 
Dealt to Hero [3s 5d 5s 9d]
Dealt to dad21c5a 
Dealt to 5c436c3 
Hero: folds
dad21c5a: folds
5c436c3: raises $0.05 to $0.07
4ba923ea: raises $0.17 to $0.24
ec497a2f: folds
80892a00: folds
5c436c3: raises $0.51 to $0.75
4ba923ea: calls $0.51
*** FLOP *** [4h Kd 5c]
5c436c3: bets $1.33 and is all-in
4ba923ea: calls $1.3 and is all-in
Uncalled bet ($0.03) returned to 5c436c3
5c436c3: shows [9s As 8s Ac] (Pair of Aces)
4ba923ea: shows [Jc Ks 9c Qd] (Pair of Kings)
*** TURN *** [4h Kd 5c] [6s]
*** RIVER *** [4h Kd 5c 6s] [2d]
*** SHOWDOWN ***
5c436c3 collected $4.04 from pot
*** SUMMARY ***
Total pot $4.13 | Rake $0.06 | Jackpot $0.03 | Bingo $0
Board [4h Kd 5c 6s 2d]
Seat 1: 4ba923ea (button) showed [Jc Ks 9c Qd] and lost with Pair of Kings
Seat 2: ec497a2f (small blind) folded before Flop
Seat 3: 80892a00 (big blind) folded before Flop
Seat 4: Hero folded before Flop (didn't bet)
Seat 5: dad21c5a folded before Flop (didn't bet)
Seat 6: 5c436c3 showed [9s As 8s Ac] and won ($4.04) with Pair of Aces


Poker Hand #RC211927275: Omaha Pot Limit  ($0.01/$0.02) - 2022/10/21 12:48:11
Table 'RushAndCash1777275' 6-max Seat #1 is the button
Seat 1: c498a10c ($2 in chips)
Seat 2: 55313f6b ($2.4 in chips)
Seat 3: e9871fe ($0.97 in chips)
Seat 4: 612276db ($2.92 in chips)
Seat 5: Hero ($1.91 in chips)
Seat 6: 39fd35b2 ($2.13 in chips)
55313f6b: posts small blind $0.01
e9871fe: posts big blind $0.02
*** HOLE CARDS ***
Dealt to c498a10c 
Dealt to 55313f6b 
Dealt to e9871fe 
Dealt to 612276db 
Dealt to Hero [Jh 8h Qd Kh]
Dealt to 39fd35b2 
612276db: folds
Hero: folds
39fd35b2: raises $0.05 to $0.07
c498a10c: folds
55313f6b: calls $0.06
e9871fe: folds
*** FLOP *** [4c 3s Tc]
55313f6b: checks
39fd35b2: bets $0.12
55313f6b: raises $0.21 to $0.33
39fd35b2: raises $0.82 to $1.15
55313f6b: raises $1.18 to $2.33 and is all-in
39fd35b2: calls $0.91 and is all-in
Uncalled bet ($0.27) returned to 55313f6b
55313f6b: shows [4h 8d Ah 4d] (Three Fours)
39fd35b2: shows [6s 3c Kc Kd] (Pair of Kings)
*** TURN *** [4c 3s Tc] [9c]
*** RIVER *** [4c 3s Tc 9c] [Ac]
*** SHOWDOWN ***
39fd35b2 collected $4.19 from pot
*** SUMMARY ***
Total pot $4.28 | Rake $0.06 | Jackpot $0.03 | Bingo $0
Board [4c 3s Tc 9c Ac]
Seat 1: c498a10c (button) folded before Flop (didn't bet)
Seat 2: 55313f6b (small blind) showed [4h 8d Ah 4d] and lost with Three Fours
Seat 3: e9871fe (big blind) folded before Flop
Seat 4: 612276db folded before Flop (didn't bet)
Seat 5: Hero folded before Flop (didn't bet)
Seat 6: 39fd35b2 showed [6s 3c Kc Kd] and won ($4.19) with Ace High Flush


Poker Hand #RC211927268: Omaha Pot Limit  ($0.01/$0.02) - 2022/10/21 12:48:07
Table 'RushAndCash1777268' 6-max Seat #1 is the button
Seat 1: 612276db ($2.92 in chips)
Seat 2: cb5cfb3c ($1.5 in chips)
Seat 3: Hero ($1.93 in chips)
Seat 4: 46bd72d4 ($0.84 in chips)
Seat 5: da0ce77b ($5.41 in chips)
Seat 6: 4ce2d7a0 ($4.83 in chips)
cb5cfb3c: posts small blind $0.01
Hero: posts big blind $0.02
*** HOLE CARDS ***
Dealt to 612276db 
Dealt to cb5cfb3c 
Dealt to Hero [3d 8c 4s 9c]
Dealt to 46bd72d4 
Dealt to da0ce77b 
Dealt to 4ce2d7a0 
46bd72d4: raises $0.02 to $0.04
da0ce77b: folds
4ce2d7a0: folds
612276db: folds
cb5cfb3c: calls $0.03
Hero: folds
*** FLOP *** [6s 4h Tc]
cb5cfb3c: checks
46bd72d4: checks
*** TURN *** [6s 4h Tc] [Qh]
cb5cfb3c: checks
46bd72d4: checks
*** RIVER *** [6s 4h Tc Qh] [5d]
cb5cfb3c: checks
46bd72d4: checks
cb5cfb3c: shows [8s Ad Qd 2s] (Pair of Queens)
46bd72d4: shows [7d Ac 9d 4c] (Pair of Fours)
*** SHOWDOWN ***
cb5cfb3c collected $0.1 from pot
*** SUMMARY ***
Total pot $0.1 | Rake $0 | Jackpot $0 | Bingo $0
Board [6s 4h Tc Qh 5d]
Seat 1: 612276db (button) folded before Flop (didn't bet)
Seat 2: cb5cfb3c (small blind) showed [8s Ad Qd 2s] and won ($0.1) with Pair of Queens
Seat 3: Hero (big blind) folded before Flop
Seat 4: 46bd72d4 showed [7d Ac 9d 4c] and lost with Pair of Fours
Seat 5: da0ce77b folded before Flop (didn't bet)
Seat 6: 4ce2d7a0 folded before Flop (didn't bet)


Poker Hand #RC211927254: Omaha Pot Limit  ($0.01/$0.02) - 2022/10/21 12:48:00
Table 'RushAndCash1777254' 6-max Seat #1 is the button
Seat 1: efa6db66 ($2.05 in chips)
Seat 2: 22360ffd ($2.71 in chips)
Seat 3: 4530f74e ($2.56 in chips)
Seat 4: Hero ($1.93 in chips)
Seat 5: 85e58b19 ($4.13 in chips)
Seat 6: f229addc ($6.99 in chips)
22360ffd: posts small blind $0.01
4530f74e: posts big blind $0.02
*** HOLE CARDS ***
Dealt to efa6db66 
Dealt to 22360ffd 
Dealt to 4530f74e 
Dealt to Hero [5c As Jh Td]
Dealt to 85e58b19 
Dealt to f229addc 
Hero: folds
85e58b19: folds
f229addc: folds
efa6db66: folds
22360ffd: raises $0.03 to $0.05
4530f74e: calls $0.03
*** FLOP *** [Kc Qh Ah]
22360ffd: checks
4530f74e: checks
*** TURN *** [Kc Qh Ah] [7h]
22360ffd: checks
4530f74e: bets $0.06
22360ffd: folds
Uncalled bet ($0.06) returned to 4530f74e
*** SHOWDOWN ***
4530f74e collected $0.1 from pot
*** SUMMARY ***
Total pot $0.1 | Rake $0 | Jackpot $0 | Bingo $0
Board [Kc Qh Ah 7h]
Seat 1: efa6db66 (button) folded before Flop (didn't bet)
Seat 2: 22360ffd (small blind) folded on the Turn
Seat 3: 4530f74e (big blind) won ($0.1)
Seat 4: Hero folded before Flop (didn't bet)
Seat 5: 85e58b19 folded before Flop (didn't bet)
Seat 6: f229addc folded before Flop (didn't bet)


Poker Hand #RC211927214: Omaha Pot Limit  ($0.01/$0.02) - 2022/10/21 12:47:43
Table 'RushAndCash1777214' 6-max Seat #1 is the button
Seat 1: Hero ($1.93 in chips)
Seat 2: 6c5b1ad4 ($2 in chips)
Seat 3: c498a10c ($2 in chips)
Seat 4: b7e034ba ($2.02 in chips)
Seat 5: 16be129e ($3.39 in chips)
Seat 6: 33d39dbc ($2.32 in chips)
6c5b1ad4: posts small blind $0.01
c498a10c: posts big blind $0.02
*** HOLE CARDS ***
Dealt to Hero [8c 2c Ks 2s]
Dealt to 6c5b1ad4 
Dealt to c498a10c 
Dealt to b7e034ba 
Dealt to 16be129e 
Dealt to 33d39dbc 
b7e034ba: folds
16be129e: folds
33d39dbc: raises $0.05 to $0.07
Hero: folds
6c5b1ad4: folds
c498a10c: folds
Uncalled bet ($0.05) returned to 33d39dbc
*** SHOWDOWN ***
33d39dbc collected $0.05 from pot
*** SUMMARY ***
Total pot $0.05 | Rake $0 | Jackpot $0 | Bingo $0
Seat 1: Hero (button) folded before Flop (didn't bet)
Seat 2: 6c5b1ad4 (small blind) folded before Flop
Seat 3: c498a10c (big blind) folded before Flop
Seat 4: b7e034ba folded before Flop (didn't bet)
Seat 5: 16be129e folded before Flop (didn't bet)
Seat 6: 33d39dbc collected ($0.05)


Poker Hand #RC211927194: Omaha Pot Limit  ($0.01/$0.02) - 2022/10/21 12:47:36
Table 'RushAndCash1777194' 6-max Seat #1 is the button
Seat 1: 85e58b19 ($4.11 in chips)
Seat 2: Hero ($1.94 in chips)
Seat 3: ca792926 ($2.25 in chips)
Seat 4: 70f7f662 ($10.82 in chips)
Seat 5: 2b2cf699 ($8.8 in chips)
Seat 6: 4c235fde ($3.07 in chips)
Hero: posts small blind $0.01
ca792926: posts big blind $0.02
*** HOLE CARDS ***
Dealt to 85e58b19 
Dealt to Hero [Th 3c 5h Td]
Dealt to ca792926 
Dealt to 70f7f662 
Dealt to 2b2cf699 
Dealt to 4c235fde 
70f7f662: folds
2b2cf699: raises $0.05 to $0.07
4c235fde: folds
85e58b19: folds
Hero: folds
ca792926: folds
Uncalled bet ($0.05) returned to 2b2cf699
*** SHOWDOWN ***
2b2cf699 collected $0.05 from pot
*** SUMMARY ***
Total pot $0.05 | Rake $0 | Jackpot $0 | Bingo $0
Seat 1: 85e58b19 (button) folded before Flop (didn't bet)
Seat 2: Hero (small blind) folded before Flop
Seat 3: ca792926 (big blind) folded before Flop
Seat 4: 70f7f662 folded before Flop (didn't bet)
Seat 5: 2b2cf699 collected ($0.05)
Seat 6: 4c235fde folded before Flop (didn't bet)


Poker Hand #RC211927178: Omaha Pot Limit  ($0.01/$0.02) - 2022/10/21 12:47:29
Table 'RushAndCash1777178' 6-max Seat #1 is the button
Seat 1: db5462ed ($2.71 in chips)
Seat 2: c78ac035 ($1.21 in chips)
Seat 3: 1cdf0782 ($2.35 in chips)
Seat 4: f2e2bb8f ($4.96 in chips)
Seat 5: Hero ($1.94 in chips)
Seat 6: d62d0ee2 ($0.5 in chips)
c78ac035: posts small blind $0.01
1cdf0782: posts big blind $0.02
*** HOLE CARDS ***
Dealt to db5462ed 
Dealt to c78ac035 
Dealt to 1cdf0782 
Dealt to f2e2bb8f 
Dealt to Hero [4c 6d 5s Qd]
Dealt to d62d0ee2 
f2e2bb8f: folds
Hero: folds
d62d0ee2: raises $0.05 to $0.07
db5462ed: folds
c78ac035: folds
1cdf0782: folds
Uncalled bet ($0.05) returned to d62d0ee2
*** SHOWDOWN ***
d62d0ee2 collected $0.05 from pot
*** SUMMARY ***
Total pot $0.05 | Rake $0 | Jackpot $0 | Bingo $0
Seat 1: db5462ed (button) folded before Flop (didn't bet)
Seat 2: c78ac035 (small blind) folded before Flop
Seat 3: 1cdf0782 (big blind) folded before Flop
Seat 4: f2e2bb8f folded before Flop (didn't bet)
Seat 5: Hero folded before Flop (didn't bet)
Seat 6: d62d0ee2 collected ($0.05)


Poker Hand #RC211927024: Omaha Pot Limit  ($0.01/$0.02) - 2022/10/21 12:46:18
Table 'RushAndCash1777024' 6-max Seat #1 is the button
Seat 1: f295722e ($8.68 in chips)
Seat 2: 4065cf4 ($2.46 in chips)
Seat 3: Hero ($1.58 in chips)
Seat 4: c0930254 ($2 in chips)
Seat 5: d62d0ee2 ($0.84 in chips)
Seat 6: a785905a ($2.01 in chips)
4065cf4: posts small blind $0.01
Hero: posts big blind $0.02
*** HOLE CARDS ***
Dealt to f295722e 
Dealt to 4065cf4 
Dealt to Hero [Ah 3s Ac 7s]
Dealt to c0930254 
Dealt to d62d0ee2 
Dealt to a785905a 
c0930254: folds
d62d0ee2: raises $0.05 to $0.07
a785905a: folds
f295722e: calls $0.07
4065cf4: folds
Hero: calls $0.05
*** FLOP *** [9s 9d 9h]
Hero: checks
d62d0ee2: bets $0.08
f295722e: folds
Hero: calls $0.08
*** TURN *** [9s 9d 9h] [4s]
Hero: checks
d62d0ee2: bets $0.19
Hero: calls $0.19
*** RIVER *** [9s 9d 9h 4s] [5s]
Hero: checks
d62d0ee2: checks
Hero: shows [Ah 3s Ac 7s] (Nines Full over Aces)
d62d0ee2: shows [7d 7h 3d 5c] (Nines Full over Sevens)
*** SHOWDOWN ***
Hero collected $0.7 from pot
*** SUMMARY ***
Total pot $0.76 | Rake $0.03 | Jackpot $0.03 | Bingo $0
Board [9s 9d 9h 4s 5s]
Seat 1: f295722e (button) folded on the Flop
Seat 2: 4065cf4 (small blind) folded before Flop
Seat 3: Hero (big blind) showed [Ah 3s Ac 7s] and won ($0.7) with Nines Full over Aces
Seat 4: c0930254 folded before Flop (didn't bet)
Seat 5: d62d0ee2 showed [7d 7h 3d 5c] and lost with Nines Full over Sevens
Seat 6: a785905a folded before Flop (didn't bet)


Poker Hand #RC211926769: Omaha Pot Limit  ($0.01/$0.02) - 2022/10/21 12:44:32
Table 'RushAndCash1776769' 6-max Seat #1 is the button
Seat 1: 9d858852 ($2.48 in chips)
Seat 2: 55313f6b ($2.41 in chips)
Seat 3: d3e1cc8f ($2.05 in chips)
Seat 4: d62d0ee2 ($1.12 in chips)
Seat 5: Hero ($1.28 in chips)
Seat 6: aafcfc55 ($2.16 in chips)
55313f6b: posts small blind $0.01
d3e1cc8f: posts big blind $0.02
*** HOLE CARDS ***
Dealt to 9d858852 
Dealt to 55313f6b 
Dealt to d3e1cc8f 
Dealt to d62d0ee2 
Dealt to Hero [4h Qs Ks Kd]
Dealt to aafcfc55 
d62d0ee2: raises $0.05 to $0.07
Hero: calls $0.07
aafcfc55: folds
9d858852: folds
55313f6b: folds
d3e1cc8f: calls $0.05
*** FLOP *** [Kh 6s 6h]
d3e1cc8f: checks
d62d0ee2: checks
Hero: bets $0.08
d3e1cc8f: folds
d62d0ee2: calls $0.08
*** TURN *** [Kh 6s 6h] [Jd]
d62d0ee2: checks
Hero: bets $0.13
d62d0ee2: calls $0.13
*** RIVER *** [Kh 6s 6h Jd] [6c]
d62d0ee2: checks
Hero: bets $0.22
d62d0ee2: folds
Uncalled bet ($0.22) returned to Hero
*** SHOWDOWN ***
Hero collected $0.58 from pot
*** SUMMARY ***
Total pot $0.64 | Rake $0.03 | Jackpot $0.03 | Bingo $0
Board [Kh 6s 6h Jd 6c]
Seat 1: 9d858852 (button) folded before Flop (didn't bet)
Seat 2: 55313f6b (small blind) folded before Flop
Seat 3: d3e1cc8f (big blind) folded on the Flop
Seat 4: d62d0ee2 folded on the River
Seat 5: Hero won ($0.58)
Seat 6: aafcfc55 folded before Flop (didn't bet)


Poker Hand #RC211926729: Omaha Pot Limit  ($0.01/$0.02) - 2022/10/21 12:44:17
Table 'RushAndCash1776729' 6-max Seat #1 is the button
Seat 1: 9ba0a360 ($1.01 in chips)
Seat 2: Hero ($1.29 in chips)
Seat 3: 34da3560 ($2.31 in chips)
Seat 4: ca97c0ff ($2 in chips)
Seat 5: 231cc405 ($2.23 in chips)
Seat 6: 1b5333a0 ($1.85 in chips)
Hero: posts small blind $0.01
34da3560: posts big blind $0.02
*** HOLE CARDS ***
Dealt to 9ba0a360 
Dealt to Hero [5d 3d 5h Kd]
Dealt to 34da3560 
Dealt to ca97c0ff 
Dealt to 231cc405 
Dealt to 1b5333a0 
ca97c0ff: folds
231cc405: folds
1b5333a0: raises $0.05 to $0.07
9ba0a360: folds
Hero: folds
34da3560: calls $0.05
*** FLOP *** [7c 9c 6c]
34da3560: checks
1b5333a0: checks
*** TURN *** [7c 9c 6c] [Js]
34da3560: checks
1b5333a0: bets $0.05
34da3560: folds
Uncalled bet ($0.05) returned to 1b5333a0
*** SHOWDOWN ***
1b5333a0 collected $0.15 from pot
*** SUMMARY ***
Total pot $0.15 | Rake $0 | Jackpot $0 | Bingo $0
Board [7c 9c 6c Js]
Seat 1: 9ba0a360 (button) folded before Flop (didn't bet)
Seat 2: Hero (small blind) folded before Flop
Seat 3: 34da3560 (big blind) folded on the Turn
Seat 4: ca97c0ff folded before Flop (didn't bet)
Seat 5: 231cc405 folded before Flop (didn't bet)
Seat 6: 1b5333a0 won ($0.15)


Poker Hand #RC211926718: Omaha Pot Limit  ($0.01/$0.02) - 2022/10/21 12:44:14
Table 'RushAndCash1776718' 6-max Seat #1 is the button
Seat 1: d52a0e64 ($2 in chips)
Seat 2: 71c24ec5 ($4.91 in chips)
Seat 3: c10a0fbc ($3.82 in chips)
Seat 4: dfb4236e ($2.03 in chips)
Seat 5: dd136d0c ($5.56 in chips)
Seat 6: Hero ($1.29 in chips)
71c24ec5: posts small blind $0.01
c10a0fbc: posts big blind $0.02
*** HOLE CARDS ***
Dealt to d52a0e64 
Dealt to 71c24ec5 
Dealt to c10a0fbc 
Dealt to dfb4236e 
Dealt to dd136d0c 
Dealt to Hero [9c Jd 7c 9h]
dfb4236e: folds
dd136d0c: folds
Hero: folds
d52a0e64: raises $0.03 to $0.05
71c24ec5: folds
c10a0fbc: calls $0.03
*** FLOP *** [4s 7s Tc]
c10a0fbc: checks
d52a0e64: bets $0.08
c10a0fbc: raises $0.27 to $0.35
d52a0e64: calls $0.27
*** TURN *** [4s 7s Tc] [Ac]
c10a0fbc: bets $0.81
d52a0e64: folds
Uncalled bet ($0.81) returned to c10a0fbc
*** SHOWDOWN ***
c10a0fbc collected $0.75 from pot
*** SUMMARY ***
Total pot $0.81 | Rake $0.03 | Jackpot $0.03 | Bingo $0
Board [4s 7s Tc Ac]
Seat 1: d52a0e64 (button) folded on the Turn
Seat 2: 71c24ec5 (small blind) folded before Flop
Seat 3: c10a0fbc (big blind) won ($0.75)
Seat 4: dfb4236e folded before Flop (didn't bet)
Seat 5: dd136d0c folded before Flop (didn't bet)
Seat 6: Hero folded before Flop (didn't bet)


Poker Hand #RC211926699: Omaha Pot Limit  ($0.01/$0.02) - 2022/10/21 12:44:07
Table 'RushAndCash1776699' 6-max Seat #1 is the button
Seat 1: Hero ($1.29 in chips)
Seat 2: 5c436c3 ($2 in chips)
Seat 3: 1a8ba4a ($11.17 in chips)
Seat 4: 75402b95 ($2 in chips)
Seat 5: 5f9f0099 ($7.68 in chips)
Seat 6: 96bbebbc ($7.67 in chips)
5c436c3: posts small blind $0.01
1a8ba4a: posts big blind $0.02
*** HOLE CARDS ***
Dealt to Hero [Td Kc 7s 5h]
Dealt to 5c436c3 
Dealt to 1a8ba4a 
Dealt to 75402b95 
Dealt to 5f9f0099 
Dealt to 96bbebbc 
75402b95: folds
5f9f0099: raises $0.02 to $0.04
96bbebbc: folds
Hero: folds
5c436c3: folds
1a8ba4a: calls $0.02
*** FLOP *** [Jh 9c Tc]
1a8ba4a: checks
5f9f0099: bets $0.09
1a8ba4a: calls $0.09
*** TURN *** [Jh 9c Tc] [5s]
1a8ba4a: checks
5f9f0099: bets $0.27
1a8ba4a: calls $0.27
*** RIVER *** [Jh 9c Tc 5s] [8c]
1a8ba4a: checks
5f9f0099: checks
1a8ba4a: shows [Qs 7d Ks 9d] (Kings-High Straight)
5f9f0099: shows [Ts 7h Th 8s] (Jacks-High Straight)
*** SHOWDOWN ***
1a8ba4a collected $0.75 from pot
*** SUMMARY ***
Total pot $0.81 | Rake $0.03 | Jackpot $0.03 | Bingo $0
Board [Jh 9c Tc 5s 8c]
Seat 1: Hero (button) folded before Flop (didn't bet)
Seat 2: 5c436c3 (small blind) folded before Flop
Seat 3: 1a8ba4a (big blind) showed [Qs 7d Ks 9d] and won ($0.75) with Kings-High Straight
Seat 4: 75402b95 folded before Flop (didn't bet)
Seat 5: 5f9f0099 showed [Ts 7h Th 8s] and lost with Jacks-High Straight
Seat 6: 96bbebbc folded before Flop (didn't bet)


Poker Hand #RC211926689: Omaha Pot Limit  ($0.01/$0.02) - 2022/10/21 12:44:03
Table 'RushAndCash1776689' 6-max Seat #1 is the button
Seat 1: db5462ed ($5.15 in chips)
Seat 2: 53141459 ($2 in chips)
Seat 3: 1d97e8a9 ($2.78 in chips)
Seat 4: 223f5e09 ($2 in chips)
Seat 5: Hero ($1.29 in chips)
Seat 6: 96bbebbc ($7.67 in chips)
53141459: posts small blind $0.01
1d97e8a9: posts big blind $0.02
*** HOLE CARDS ***
Dealt to db5462ed 
Dealt to 53141459 
Dealt to 1d97e8a9 
Dealt to 223f5e09 
Dealt to Hero [6s Jh Tc Ts]
Dealt to 96bbebbc 
223f5e09: folds
Hero: folds
96bbebbc: folds
db5462ed: folds
53141459: raises $0.04 to $0.06
1d97e8a9: calls $0.04
*** FLOP *** [4h Kc Jc]
53141459: checks
1d97e8a9: checks
*** TURN *** [4h Kc Jc] [6c]
53141459: checks
1d97e8a9: checks
*** RIVER *** [4h Kc Jc 6c] [Ac]
53141459: checks
1d97e8a9: checks
53141459: shows [As 8h 9s Qc] (Pair of Aces)
1d97e8a9: shows [7c 8d 8s 7h] (Pair of Eights)
*** SHOWDOWN ***
53141459 collected $0.12 from pot
*** SUMMARY ***
Total pot $0.12 | Rake $0 | Jackpot $0 | Bingo $0
Board [4h Kc Jc 6c Ac]
Seat 1: db5462ed (button) folded before Flop (didn't bet)
Seat 2: 53141459 (small blind) showed [As 8h 9s Qc] and won ($0.12) with Pair of Aces
Seat 3: 1d97e8a9 (big blind) showed [7c 8d 8s 7h] and lost with Pair of Eights
Seat 4: 223f5e09 folded before Flop (didn't bet)
Seat 5: Hero folded before Flop (didn't bet)
Seat 6: 96bbebbc folded before Flop (didn't bet)


Poker Hand #RC211926673: Omaha Pot Limit  ($0.01/$0.02) - 2022/10/21 12:43:57
Table 'RushAndCash1776673' 6-max Seat #1 is the button
Seat 1: eb40d2f3 ($2.29 in chips)
Seat 2: 2471b03 ($0.98 in chips)
Seat 3: b7e034ba ($2 in chips)
Seat 4: Hero ($1.29 in chips)
Seat 5: 1a8ba4a ($11.17 in chips)
Seat 6: cd9739d7 ($2.03 in chips)
2471b03: posts small blind $0.01
b7e034ba: posts big blind $0.02
*** HOLE CARDS ***
Dealt to eb40d2f3 
Dealt to 2471b03 
Dealt to b7e034ba 
Dealt to Hero [3d 6h 6s Kc]
Dealt to 1a8ba4a 
Dealt to cd9739d7 
Hero: folds
1a8ba4a: folds
cd9739d7: folds
eb40d2f3: folds
2471b03: folds
Uncalled bet ($0.01) returned to b7e034ba
*** SHOWDOWN ***
b7e034ba collected $0.02 from pot
*** SUMMARY ***
Total pot $0.02 | Rake $0 | Jackpot $0 | Bingo $0
Seat 1: eb40d2f3 (button) folded before Flop (didn't bet)
Seat 2: 2471b03 (small blind) folded before Flop
Seat 3: b7e034ba (big blind) collected ($0.02)
Seat 4: Hero folded before Flop (didn't bet)
Seat 5: 1a8ba4a folded before Flop (didn't bet)
Seat 6: cd9739d7 folded before Flop (didn't bet)


Poker Hand #RC211926656: Omaha Pot Limit  ($0.01/$0.02) - 2022/10/21 12:43:51
Table 'RushAndCash1776656' 6-max Seat #1 is the button
Seat 1: 4065cf4 ($2.57 in chips)
Seat 2: 71eb6774 ($1.26 in chips)
Seat 3: fee0e58a ($2.65 in chips)
Seat 4: Hero ($1.29 in chips)
Seat 5: 12a83aff ($0.87 in chips)
Seat 6: e1ba933c ($2.03 in chips)
71eb6774: posts small blind $0.01
fee0e58a: posts big blind $0.02
*** HOLE CARDS ***
Dealt to 4065cf4 
Dealt to 71eb6774 
Dealt to fee0e58a 
Dealt to Hero [2c Qs Ac 9d]
Dealt to 12a83aff 
Dealt to e1ba933c 
Hero: folds
12a83aff: folds
e1ba933c: folds
4065cf4: folds
71eb6774: raises $0.04 to $0.06
fee0e58a: calls $0.04
*** FLOP *** [4s Js 7c]
71eb6774: bets $0.12
fee0e58a: folds
Uncalled bet ($0.12) returned to 71eb6774
*** SHOWDOWN ***
71eb6774 collected $0.12 from pot
*** SUMMARY ***
Total pot $0.12 | Rake $0 | Jackpot $0 | Bingo $0
Board [4s Js 7c]
Seat 1: 4065cf4 (button) folded before Flop (didn't bet)
Seat 2: 71eb6774 (small blind) won ($0.12)
Seat 3: fee0e58a (big blind) folded on the Flop
Seat 4: Hero folded before Flop (didn't bet)
Seat 5: 12a83aff folded before Flop (didn't bet)
Seat 6: e1ba933c folded before Flop (didn't bet)


Poker Hand #RC211926649: Omaha Pot Limit  ($0.01/$0.02) - 2022/10/21 12:43:48
Table 'RushAndCash1776649' 6-max Seat #1 is the button
Seat 1: 6bebea35 ($2 in chips)
Seat 2: 8cb8a924 ($5.77 in chips)
Seat 3: 6a90d83f ($2.77 in chips)
Seat 4: 3be5e736 ($2.71 in chips)
Seat 5: 71bf1949 ($1.81 in chips)
Seat 6: Hero ($1.29 in chips)
8cb8a924: posts small blind $0.01
6a90d83f: posts big blind $0.02
*** HOLE CARDS ***
Dealt to 6bebea35 
Dealt to 8cb8a924 
Dealt to 6a90d83f 
Dealt to 3be5e736 
Dealt to 71bf1949 
Dealt to Hero [3d 7c 4h Qd]
3be5e736: folds
71bf1949: folds
Hero: folds
6bebea35: folds
8cb8a924: folds
Uncalled bet ($0.01) returned to 6a90d83f
*** SHOWDOWN ***
6a90d83f collected $0.02 from pot
*** SUMMARY ***
Total pot $0.02 | Rake $0 | Jackpot $0 | Bingo $0
Seat 1: 6bebea35 (button) folded before Flop (didn't bet)
Seat 2: 8cb8a924 (small blind) folded before Flop
Seat 3: 6a90d83f (big blind) collected ($0.02)
Seat 4: 3be5e736 folded before Flop (didn't bet)
Seat 5: 71bf1949 folded before Flop (didn't bet)
Seat 6: Hero folded before Flop (didn't bet)


Poker Hand #RC211926615: Omaha Pot Limit  ($0.01/$0.02) - 2022/10/21 12:43:34
Table 'RushAndCash1776615' 6-max Seat #1 is the button
Seat 1: 239958fb ($2.31 in chips)
Seat 2: 3be5e736 ($2.72 in chips)
Seat 3: Hero ($1.31 in chips)
Seat 4: c0930254 ($2 in chips)
Seat 5: 47700101 ($2.65 in chips)
Seat 6: 61b92208 ($16.16 in chips)
3be5e736: posts small blind $0.01
Hero: posts big blind $0.02
*** HOLE CARDS ***
Dealt to 239958fb 
Dealt to 3be5e736 
Dealt to Hero [As 6c 2c 4h]
Dealt to c0930254 
Dealt to 47700101 
Dealt to 61b92208 
c0930254: folds
47700101: folds
61b92208: raises $0.02 to $0.04
239958fb: folds
3be5e736: folds
Hero: folds
Uncalled bet ($0.02) returned to 61b92208
*** SHOWDOWN ***
61b92208 collected $0.05 from pot
*** SUMMARY ***
Total pot $0.05 | Rake $0 | Jackpot $0 | Bingo $0
Seat 1: 239958fb (button) folded before Flop (didn't bet)
Seat 2: 3be5e736 (small blind) folded before Flop
Seat 3: Hero (big blind) folded before Flop
Seat 4: c0930254 folded before Flop (didn't bet)
Seat 5: 47700101 folded before Flop (didn't bet)
Seat 6: 61b92208 collected ($0.05)


Poker Hand #RC211926604: Omaha Pot Limit  ($0.01/$0.02) - 2022/10/21 12:43:30
Table 'RushAndCash1776604' 6-max Seat #1 is the button
Seat 1: Hero ($1.31 in chips)
Seat 2: 60c62cbf ($5.12 in chips)
Seat 3: 792e227 ($14.29 in chips)
Seat 4: 201d8c95 ($2.24 in chips)
Seat 5: 5e85d999 ($3.02 in chips)
Seat 6: e312c4bc ($2.53 in chips)
60c62cbf: posts small blind $0.01
792e227: posts big blind $0.02
*** HOLE CARDS ***
Dealt to Hero [7d 8d 5d 6d]
Dealt to 60c62cbf 
Dealt to 792e227 
Dealt to 201d8c95 
Dealt to 5e85d999 
Dealt to e312c4bc 
201d8c95: folds
5e85d999: folds
e312c4bc: folds
Hero: folds
60c62cbf: folds
Uncalled bet ($0.01) returned to 792e227
*** SHOWDOWN ***
792e227 collected $0.02 from pot
*** SUMMARY ***
Total pot $0.02 | Rake $0 | Jackpot $0 | Bingo $0
Seat 1: Hero (button) folded before Flop (didn't bet)
Seat 2: 60c62cbf (small blind) folded before Flop
Seat 3: 792e227 (big blind) collected ($0.02)
Seat 4: 201d8c95 folded before Flop (didn't bet)
Seat 5: 5e85d999 folded before Flop (didn't bet)
Seat 6: e312c4bc folded before Flop (didn't bet)


Poker Hand #RC211926511: Omaha Pot Limit  ($0.01/$0.02) - 2022/10/21 12:42:49
Table 'RushAndCash1776511' 6-max Seat #1 is the button
Seat 1: 4beb7f7c ($2.25 in chips)
Seat 2: Hero ($1.43 in chips)
Seat 3: b8bdc23f ($3.86 in chips)
Seat 4: 71eb6774 ($1.31 in chips)
Seat 5: 7cf97e5c ($2 in chips)
Seat 6: eae6d401 ($4.3 in chips)
Hero: posts small blind $0.01
b8bdc23f: posts big blind $0.02
*** HOLE CARDS ***
Dealt to 4beb7f7c 
Dealt to Hero [Ac 4c Kh Kc]
Dealt to b8bdc23f 
Dealt to 71eb6774 
Dealt to 7cf97e5c 
Dealt to eae6d401 
71eb6774: folds
7cf97e5c: folds
eae6d401: folds
4beb7f7c: folds
Hero: raises $0.04 to $0.06
b8bdc23f: calls $0.04
*** FLOP *** [3s 2h Ts]
Hero: bets $0.06
b8bdc23f: raises $0.24 to $0.3
Hero: folds
Uncalled bet ($0.24) returned to b8bdc23f
*** SHOWDOWN ***
b8bdc23f collected $0.23 from pot
*** SUMMARY ***
Total pot $0.24 | Rake $0.01 | Jackpot $0 | Bingo $0
Board [3s 2h Ts]
Seat 1: 4beb7f7c (button) folded before Flop (didn't bet)
Seat 2: Hero (small blind) folded on the Flop
Seat 3: b8bdc23f (big blind) won ($0.23)
Seat 4: 71eb6774 folded before Flop (didn't bet)
Seat 5: 7cf97e5c folded before Flop (didn't bet)
Seat 6: eae6d401 folded before Flop (didn't bet)


Poker Hand #RC211926488: Omaha Pot Limit  ($0.01/$0.02) - 2022/10/21 12:42:39
Table 'RushAndCash1776488' 6-max Seat #1 is the button
Seat 1: 201d8c95 ($2.32 in chips)
Seat 2: 4530f74e ($2.65 in chips)
Seat 3: 971ded4e ($2.43 in chips)
Seat 4: Hero ($1.43 in chips)
Seat 5: f2e2bb8f ($5.02 in chips)
Seat 6: 410805fa ($4.19 in chips)
4530f74e: posts small blind $0.01
971ded4e: posts big blind $0.02
*** HOLE CARDS ***
Dealt to 201d8c95 
Dealt to 4530f74e 
Dealt to 971ded4e 
Dealt to Hero [Jc 4s Jd 8c]
Dealt to f2e2bb8f 
Dealt to 410805fa 
Hero: folds
f2e2bb8f: folds
410805fa: folds
201d8c95: folds
4530f74e: raises $0.04 to $0.06
971ded4e: folds
Uncalled bet ($0.04) returned to 4530f74e
*** SHOWDOWN ***
4530f74e collected $0.04 from pot
*** SUMMARY ***
Total pot $0.04 | Rake $0 | Jackpot $0 | Bingo $0
Seat 1: 201d8c95 (button) folded before Flop (didn't bet)
Seat 2: 4530f74e (small blind) collected ($0.04)
Seat 3: 971ded4e (big blind) folded before Flop
Seat 4: Hero folded before Flop (didn't bet)
Seat 5: f2e2bb8f folded before Flop (didn't bet)
Seat 6: 410805fa folded before Flop (didn't bet)


Poker Hand #RC211926476: Omaha Pot Limit  ($0.01/$0.02) - 2022/10/21 12:42:33
Table 'RushAndCash1776476' 6-max Seat #1 is the button
Seat 1: b07fa5fc ($2.01 in chips)
Seat 2: 17c11c29 ($2.63 in chips)
Seat 3: Hero ($1.45 in chips)
Seat 4: 6a90d83f ($2.56 in chips)
Seat 5: 971ded4e ($2.43 in chips)
Seat 6: 7cc03d50 ($2.79 in chips)
17c11c29: posts small blind $0.01
Hero: posts big blind $0.02
*** HOLE CARDS ***
Dealt to b07fa5fc 
Dealt to 17c11c29 
Dealt to Hero [Qh 2d 9d 9s]
Dealt to 6a90d83f 
Dealt to 971ded4e 
Dealt to 7cc03d50 
6a90d83f: raises $0.05 to $0.07
971ded4e: folds
7cc03d50: calls $0.07
b07fa5fc: folds
17c11c29: folds
Hero: folds
*** FLOP *** [Jh Th Ac]
6a90d83f: bets $0.09
7cc03d50: calls $0.09
*** TURN *** [Jh Th Ac] [5c]
6a90d83f: bets $0.27
7cc03d50: folds
Uncalled bet ($0.27) returned to 6a90d83f
*** SHOWDOWN ***
6a90d83f collected $0.34 from pot
*** SUMMARY ***
Total pot $0.35 | Rake $0.01 | Jackpot $0 | Bingo $0
Board [Jh Th Ac 5c]
Seat 1: b07fa5fc (button) folded before Flop (didn't bet)
Seat 2: 17c11c29 (small blind) folded before Flop
Seat 3: Hero (big blind) folded before Flop
Seat 4: 6a90d83f won ($0.34)
Seat 5: 971ded4e folded before Flop (didn't bet)
Seat 6: 7cc03d50 folded on the Turn


Poker Hand #RC211926467: Omaha Pot Limit  ($0.01/$0.02) - 2022/10/21 12:42:29
Table 'RushAndCash1776467' 6-max Seat #1 is the button
Seat 1: f78e1a96 ($1.69 in chips)
Seat 2: f5524b6e ($3.03 in chips)
Seat 3: 73016c62 ($2.41 in chips)
Seat 4: 971ded4e ($2.43 in chips)
Seat 5: Hero ($1.45 in chips)
Seat 6: 8da43832 ($3.99 in chips)
f5524b6e: posts small blind $0.01
73016c62: posts big blind $0.02
*** HOLE CARDS ***
Dealt to f78e1a96 
Dealt to f5524b6e 
Dealt to 73016c62 
Dealt to 971ded4e 
Dealt to Hero [Jh Js 3d 5s]
Dealt to 8da43832 
971ded4e: folds
Hero: folds
8da43832: raises $0.05 to $0.07
f78e1a96: calls $0.07
f5524b6e: folds
73016c62: folds
*** FLOP *** [Qh Ks 2s]
8da43832: checks
f78e1a96: checks
*** TURN *** [Qh Ks 2s] [3h]
8da43832: checks
f78e1a96: checks
*** RIVER *** [Qh Ks 2s 3h] [Ah]
8da43832: bets $0.1
f78e1a96: folds
Uncalled bet ($0.1) returned to 8da43832
*** SHOWDOWN ***
8da43832 collected $0.17 from pot
*** SUMMARY ***
Total pot $0.17 | Rake $0 | Jackpot $0 | Bingo $0
Board [Qh Ks 2s 3h Ah]
Seat 1: f78e1a96 (button) folded on the River
Seat 2: f5524b6e (small blind) folded before Flop
Seat 3: 73016c62 (big blind) folded before Flop
Seat 4: 971ded4e folded before Flop (didn't bet)
Seat 5: Hero folded before Flop (didn't bet)
Seat 6: 8da43832 won ($0.17)


Poker Hand #RC211926459: Omaha Pot Limit  ($0.01/$0.02) - 2022/10/21 12:42:25
Table 'RushAndCash1776459' 6-max Seat #1 is the button
Seat 1: Hero ($1.45 in chips)
Seat 2: 9d858852 ($2.41 in chips)
Seat 3: 606a99f0 ($2.05 in chips)
Seat 4: 17eabed ($2 in chips)
Seat 5: be9ea11b ($2.03 in chips)
Seat 6: 599a53ee ($5.25 in chips)
9d858852: posts small blind $0.01
606a99f0: posts big blind $0.02
*** HOLE CARDS ***
Dealt to Hero [7d 6s Js 4s]
Dealt to 9d858852 
Dealt to 606a99f0 
Dealt to 17eabed 
Dealt to be9ea11b 
Dealt to 599a53ee 
17eabed: folds
be9ea11b: raises $0.05 to $0.07
599a53ee: folds
Hero: folds
9d858852: folds
606a99f0: folds
Uncalled bet ($0.05) returned to be9ea11b
*** SHOWDOWN ***
be9ea11b collected $0.05 from pot
*** SUMMARY ***
Total pot $0.05 | Rake $0 | Jackpot $0 | Bingo $0
Seat 1: Hero (button) folded before Flop (didn't bet)
Seat 2: 9d858852 (small blind) folded before Flop
Seat 3: 606a99f0 (big blind) folded before Flop
Seat 4: 17eabed folded before Flop (didn't bet)
Seat 5: be9ea11b collected ($0.05)
Seat 6: 599a53ee folded before Flop (didn't bet)


Poker Hand #RC211926451: Omaha Pot Limit  ($0.01/$0.02) - 2022/10/21 12:42:22
Table 'RushAndCash1776451' 6-max Seat #1 is the button
Seat 1: 60c62cbf ($5.04 in chips)
Seat 2: a30ea4fe ($2.29 in chips)
Seat 3: ec497a2f ($2.27 in chips)
Seat 4: cdc6c025 ($3.99 in chips)
Seat 5: Hero ($1.45 in chips)
Seat 6: 9fa75ace ($0.63 in chips)
a30ea4fe: posts small blind $0.01
ec497a2f: posts big blind $0.02
*** HOLE CARDS ***
Dealt to 60c62cbf 
Dealt to a30ea4fe 
Dealt to ec497a2f 
Dealt to cdc6c025 
Dealt to Hero [9d 2s 7c Jc]
Dealt to 9fa75ace 
cdc6c025: folds
Hero: folds
9fa75ace: calls $0.02
60c62cbf: folds
a30ea4fe: folds
ec497a2f: checks
*** FLOP *** [4h 3h 3c]
ec497a2f: checks
9fa75ace: bets $0.02
ec497a2f: calls $0.02
*** TURN *** [4h 3h 3c] [5s]
ec497a2f: checks
9fa75ace: bets $0.03
ec497a2f: folds
Uncalled bet ($0.03) returned to 9fa75ace
*** SHOWDOWN ***
9fa75ace collected $0.09 from pot
*** SUMMARY ***
Total pot $0.09 | Rake $0 | Jackpot $0 | Bingo $0
Board [4h 3h 3c 5s]
Seat 1: 60c62cbf (button) folded before Flop (didn't bet)
Seat 2: a30ea4fe (small blind) folded before Flop
Seat 3: ec497a2f (big blind) folded on the Turn
Seat 4: cdc6c025 folded before Flop (didn't bet)
Seat 5: Hero folded before Flop (didn't bet)
Seat 6: 9fa75ace won ($0.09)


Poker Hand #RC211926339: Omaha Pot Limit  ($0.01/$0.02) - 2022/10/21 12:41:28
Table 'RushAndCash1776339' 6-max Seat #1 is the button
Seat 1: 98a1ebf0 ($2.49 in chips)
Seat 2: Hero ($1.52 in chips)
Seat 3: a00fec6e ($2 in chips)
Seat 4: f23f8f77 ($0.49 in chips)
Seat 5: cdc6c025 ($3.56 in chips)
Seat 6: 86010f0f ($7.39 in chips)
Hero: posts small blind $0.01
a00fec6e: posts big blind $0.02
*** HOLE CARDS ***
Dealt to 98a1ebf0 
Dealt to Hero [9h 7h 7s Ad]
Dealt to a00fec6e 
Dealt to f23f8f77 
Dealt to cdc6c025 
Dealt to 86010f0f 
f23f8f77: folds
cdc6c025: raises $0.05 to $0.07
86010f0f: folds
98a1ebf0: folds
Hero: calls $0.06
a00fec6e: raises $0.05 to $0.12
cdc6c025: raises $0.31 to $0.43
Hero: folds
a00fec6e: calls $0.31
*** FLOP *** [2c Qs As]
a00fec6e: checks
cdc6c025: bets $0.93
a00fec6e: folds
Uncalled bet ($0.93) returned to cdc6c025
*** SHOWDOWN ***
cdc6c025 collected $0.86 from pot
*** SUMMARY ***
Total pot $0.93 | Rake $0.04 | Jackpot $0.03 | Bingo $0
Board [2c Qs As]
Seat 1: 98a1ebf0 (button) folded before Flop (didn't bet)
Seat 2: Hero (small blind) folded before Flop
Seat 3: a00fec6e (big blind) folded on the Flop
Seat 4: f23f8f77 folded before Flop (didn't bet)
Seat 5: cdc6c025 won ($0.86)
Seat 6: 86010f0f folded before Flop (didn't bet)


Poker Hand #RC211926254: Omaha Pot Limit  ($0.01/$0.02) - 2022/10/21 12:40:53
Table 'RushAndCash1776254' 6-max Seat #1 is the button
Seat 1: 2898300f ($5.84 in chips)
Seat 2: ea083dd8 ($2.13 in chips)
Seat 3: 45549b8b ($2.64 in chips)
Seat 4: 9415f42a ($2.05 in chips)
Seat 5: Hero ($1.52 in chips)
Seat 6: 1b5c2a42 ($1.86 in chips)
ea083dd8: posts small blind $0.01
45549b8b: posts big blind $0.02
*** HOLE CARDS ***
Dealt to 2898300f 
Dealt to ea083dd8 
Dealt to 45549b8b 
Dealt to 9415f42a 
Dealt to Hero [Th Tc 4c Kc]
Dealt to 1b5c2a42 
9415f42a: folds
Hero: folds
1b5c2a42: raises $0.04 to $0.06
2898300f: folds
ea083dd8: folds
45549b8b: folds
Uncalled bet ($0.04) returned to 1b5c2a42
*** SHOWDOWN ***
1b5c2a42 collected $0.05 from pot
*** SUMMARY ***
Total pot $0.05 | Rake $0 | Jackpot $0 | Bingo $0
Seat 1: 2898300f (button) folded before Flop (didn't bet)
Seat 2: ea083dd8 (small blind) folded before Flop
Seat 3: 45549b8b (big blind) folded before Flop
Seat 4: 9415f42a folded before Flop (didn't bet)
Seat 5: Hero folded before Flop (didn't bet)
Seat 6: 1b5c2a42 collected ($0.05)


Poker Hand #RC211926143: Omaha Pot Limit  ($0.01/$0.02) - 2022/10/21 12:40:08
Table 'RushAndCash1776143' 6-max Seat #1 is the button
Seat 1: 8cccaf5c ($2.11 in chips)
Seat 2: 60c62cbf ($4.92 in chips)
Seat 3: 9d0f0d4e ($2 in chips)
Seat 4: 1b5c2a42 ($1.72 in chips)
Seat 5: Hero ($1.58 in chips)
Seat 6: 7971a8b1 ($0.29 in chips)
60c62cbf: posts small blind $0.01
9d0f0d4e: posts big blind $0.02
*** HOLE CARDS ***
Dealt to 8cccaf5c 
Dealt to 60c62cbf 
Dealt to 9d0f0d4e 
Dealt to 1b5c2a42 
Dealt to Hero [Ks 8c 7c Qs]
Dealt to 7971a8b1 
1b5c2a42: calls $0.02
Hero: raises $0.04 to $0.06
7971a8b1: folds
8cccaf5c: calls $0.06
60c62cbf: folds
9d0f0d4e: folds
1b5c2a42: calls $0.04
*** FLOP *** [2c 8d Ah]
1b5c2a42: checks
Hero: checks
8cccaf5c: checks
*** TURN *** [2c 8d Ah] [5h]
1b5c2a42: checks
Hero: checks
8cccaf5c: checks
*** RIVER *** [2c 8d Ah 5h] [4c]
1b5c2a42: bets $0.17
Hero: folds
8cccaf5c: folds
Uncalled bet ($0.17) returned to 1b5c2a42
*** SHOWDOWN ***
1b5c2a42 collected $0.2 from pot
*** SUMMARY ***
Total pot $0.21 | Rake $0.01 | Jackpot $0 | Bingo $0
Board [2c 8d Ah 5h 4c]
Seat 1: 8cccaf5c (button) folded on the River
Seat 2: 60c62cbf (small blind) folded before Flop
Seat 3: 9d0f0d4e (big blind) folded before Flop
Seat 4: 1b5c2a42 won ($0.2)
Seat 5: Hero folded on the River
Seat 6: 7971a8b1 folded before Flop (didn't bet)


Poker Hand #RC211926130: Omaha Pot Limit  ($0.01/$0.02) - 2022/10/21 12:40:03
Table 'RushAndCash1776130' 6-max Seat #1 is the button
Seat 1: 7971a8b1 ($0.26 in chips)
Seat 2: 4530f74e ($2.78 in chips)
Seat 3: 319523e5 ($1.77 in chips)
Seat 4: Hero ($1.58 in chips)
Seat 5: 4ce2d7a0 ($3.37 in chips)
Seat 6: 65893a3a ($2.03 in chips)
4530f74e: posts small blind $0.01
319523e5: posts big blind $0.02
*** HOLE CARDS ***
Dealt to 7971a8b1 
Dealt to 4530f74e 
Dealt to 319523e5 
Dealt to Hero [Qc 3d Td Jd]
Dealt to 4ce2d7a0 
Dealt to 65893a3a 
Hero: folds
4ce2d7a0: folds
65893a3a: folds
7971a8b1: folds
4530f74e: folds
Uncalled bet ($0.01) returned to 319523e5
*** SHOWDOWN ***
319523e5 collected $0.02 from pot
*** SUMMARY ***
Total pot $0.02 | Rake $0 | Jackpot $0 | Bingo $0
Seat 1: 7971a8b1 (button) folded before Flop (didn't bet)
Seat 2: 4530f74e (small blind) folded before Flop
Seat 3: 319523e5 (big blind) collected ($0.02)
Seat 4: Hero folded before Flop (didn't bet)
Seat 5: 4ce2d7a0 folded before Flop (didn't bet)
Seat 6: 65893a3a folded before Flop (didn't bet)


Poker Hand #RC211926094: Omaha Pot Limit  ($0.01/$0.02) - 2022/10/21 12:39:50
Table 'RushAndCash1776094' 6-max Seat #1 is the button
Seat 1: 971ded4e ($2.41 in chips)
Seat 2: 5332240a ($1.06 in chips)
Seat 3: Hero ($1.57 in chips)
Seat 4: 606a99f0 ($2.05 in chips)
Seat 5: 5255aa86 ($2.47 in chips)
Seat 6: 4530f74e ($2.8 in chips)
5332240a: posts small blind $0.01
Hero: posts big blind $0.02
*** HOLE CARDS ***
Dealt to 971ded4e 
Dealt to 5332240a 
Dealt to Hero [Th 4s As 4h]
Dealt to 606a99f0 
Dealt to 5255aa86 
Dealt to 4530f74e 
606a99f0: folds
5255aa86: folds
4530f74e: folds
971ded4e: folds
5332240a: folds
Uncalled bet ($0.01) returned to Hero
*** SHOWDOWN ***
Hero collected $0.02 from pot
*** SUMMARY ***
Total pot $0.02 | Rake $0 | Jackpot $0 | Bingo $0
Seat 1: 971ded4e (button) folded before Flop (didn't bet)
Seat 2: 5332240a (small blind) folded before Flop
Seat 3: Hero (big blind) collected ($0.02)
Seat 4: 606a99f0 folded before Flop (didn't bet)
Seat 5: 5255aa86 folded before Flop (didn't bet)
Seat 6: 4530f74e folded before Flop (didn't bet)


Poker Hand #RC211926079: Omaha Pot Limit  ($0.01/$0.02) - 2022/10/21 12:39:45
Table 'RushAndCash1776079' 6-max Seat #1 is the button
Seat 1: Hero ($1.57 in chips)
Seat 2: 1d97e8a9 ($2.04 in chips)
Seat 3: a6c42e85 ($1.82 in chips)
Seat 4: 5397c0b1 ($0.52 in chips)
Seat 5: c10a0fbc ($3.65 in chips)
Seat 6: c78c8823 ($6.12 in chips)
1d97e8a9: posts small blind $0.01
a6c42e85: posts big blind $0.02
*** HOLE CARDS ***
Dealt to Hero [Kd 7d 9d 4d]
Dealt to 1d97e8a9 
Dealt to a6c42e85 
Dealt to 5397c0b1 
Dealt to c10a0fbc 
Dealt to c78c8823 
5397c0b1: raises $0.02 to $0.04
c10a0fbc: folds
c78c8823: folds
Hero: folds
1d97e8a9: folds
a6c42e85: calls $0.02
*** FLOP *** [2c 5d Jd]
a6c42e85: checks
5397c0b1: checks
*** TURN *** [2c 5d Jd] [6d]
a6c42e85: checks
5397c0b1: checks
*** RIVER *** [2c 5d Jd 6d] [8s]
a6c42e85: checks
5397c0b1: checks
a6c42e85: shows [Ks 4c 9s Tc] (King-High)
5397c0b1: shows [8h Th 7c 7h] (Pair of Eights)
*** SHOWDOWN ***
5397c0b1 collected $0.09 from pot
*** SUMMARY ***
Total pot $0.09 | Rake $0 | Jackpot $0 | Bingo $0
Board [2c 5d Jd 6d 8s]
Seat 1: Hero (button) folded before Flop (didn't bet)
Seat 2: 1d97e8a9 (small blind) folded before Flop
Seat 3: a6c42e85 (big blind) showed [Ks 4c 9s Tc] and lost with King-High
Seat 4: 5397c0b1 showed [8h Th 7c 7h] and won ($0.09) with Pair of Eights
Seat 5: c10a0fbc folded before Flop (didn't bet)
Seat 6: c78c8823 folded before Flop (didn't bet)


Poker Hand #RC211926069: Omaha Pot Limit  ($0.01/$0.02) - 2022/10/21 12:39:41
Table 'RushAndCash1776069' 6-max Seat #1 is the button
Seat 1: 89093cc5 ($2.03 in chips)
Seat 2: Hero ($1.58 in chips)
Seat 3: 8cb8a924 ($4.18 in chips)
Seat 4: 7badf949 ($4.69 in chips)
Seat 5: 239958fb ($2.02 in chips)
Seat 6: 88fd0c1c ($4.94 in chips)
Hero: posts small blind $0.01
8cb8a924: posts big blind $0.02
*** HOLE CARDS ***
Dealt to 89093cc5 
Dealt to Hero [7s Kc Jd 3h]
Dealt to 8cb8a924 
Dealt to 7badf949 
Dealt to 239958fb 
Dealt to 88fd0c1c 
7badf949: folds
239958fb: folds
88fd0c1c: folds
89093cc5: folds
Hero: folds
Uncalled bet ($0.01) returned to 8cb8a924
*** SHOWDOWN ***
8cb8a924 collected $0.02 from pot
*** SUMMARY ***
Total pot $0.02 | Rake $0 | Jackpot $0 | Bingo $0
Seat 1: 89093cc5 (button) folded before Flop (didn't bet)
Seat 2: Hero (small blind) folded before Flop
Seat 3: 8cb8a924 (big blind) collected ($0.02)
Seat 4: 7badf949 folded before Flop (didn't bet)
Seat 5: 239958fb folded before Flop (didn't bet)
Seat 6: 88fd0c1c folded before Flop (didn't bet)


Poker Hand #RC211926057: Omaha Pot Limit  ($0.01/$0.02) - 2022/10/21 12:39:36
Table 'RushAndCash1776057' 6-max Seat #1 is the button
Seat 1: a4e6fc19 ($1.93 in chips)
Seat 2: a978283b ($0.51 in chips)
Seat 3: f78e1a96 ($1.75 in chips)
Seat 4: b7e67cac ($6.31 in chips)
Seat 5: Hero ($1.58 in chips)
Seat 6: e7153d12 ($0.3 in chips)
a978283b: posts small blind $0.01
f78e1a96: posts big blind $0.02
*** HOLE CARDS ***
Dealt to a4e6fc19 
Dealt to a978283b 
Dealt to f78e1a96 
Dealt to b7e67cac 
Dealt to Hero [6s Kc 8h Js]
Dealt to e7153d12 
b7e67cac: folds
Hero: folds
e7153d12: folds
a4e6fc19: folds
a978283b: calls $0.01
f78e1a96: raises $0.02 to $0.04
a978283b: calls $0.02
*** FLOP *** [Ad Tc Jh]
a978283b: checks
f78e1a96: checks
*** TURN *** [Ad Tc Jh] [6h]
a978283b: checks
f78e1a96: checks
*** RIVER *** [Ad Tc Jh 6h] [Ts]
a978283b: bets $0.08
f78e1a96: folds
Uncalled bet ($0.08) returned to a978283b
*** SHOWDOWN ***
a978283b collected $0.08 from pot
*** SUMMARY ***
Total pot $0.08 | Rake $0 | Jackpot $0 | Bingo $0
Board [Ad Tc Jh 6h Ts]
Seat 1: a4e6fc19 (button) folded before Flop (didn't bet)
Seat 2: a978283b (small blind) won ($0.08)
Seat 3: f78e1a96 (big blind) folded on the River
Seat 4: b7e67cac folded before Flop (didn't bet)
Seat 5: Hero folded before Flop (didn't bet)
Seat 6: e7153d12 folded before Flop (didn't bet)


Poker Hand #RC211925902: Omaha Pot Limit  ($0.01/$0.02) - 2022/10/21 12:38:20
Table 'RushAndCash1775902' 6-max Seat #1 is the button
Seat 1: 86010f0f ($7.72 in chips)
Seat 2: 1e9ff1cd ($3.08 in chips)
Seat 3: 3be5e736 ($2.45 in chips)
Seat 4: 73add92d ($2 in chips)
Seat 5: e7153d12 ($0.34 in chips)
Seat 6: Hero ($1.51 in chips)
1e9ff1cd: posts small blind $0.01
3be5e736: posts big blind $0.02
*** HOLE CARDS ***
Dealt to 86010f0f 
Dealt to 1e9ff1cd 
Dealt to 3be5e736 
Dealt to 73add92d 
Dealt to e7153d12 
Dealt to Hero [Qh Ac 9s Jc]
73add92d: folds
e7153d12: raises $0.02 to $0.04
Hero: calls $0.04
86010f0f: folds
1e9ff1cd: folds
3be5e736: folds
*** FLOP *** [Jh 3h 6h]
e7153d12: checks
Hero: checks
*** TURN *** [Jh 3h 6h] [Kd]
e7153d12: checks
Hero: checks
*** RIVER *** [Jh 3h 6h Kd] [5d]
e7153d12: checks
Hero: checks
e7153d12: shows [2c Ad 7s Qd] (Ace-High)
Hero: shows [Qh Ac 9s Jc] (Pair of Jacks)
*** SHOWDOWN ***
Hero collected $0.11 from pot
*** SUMMARY ***
Total pot $0.11 | Rake $0 | Jackpot $0 | Bingo $0
Board [Jh 3h 6h Kd 5d]
Seat 1: 86010f0f (button) folded before Flop (didn't bet)
Seat 2: 1e9ff1cd (small blind) folded before Flop
Seat 3: 3be5e736 (big blind) folded before Flop
Seat 4: 73add92d folded before Flop (didn't bet)
Seat 5: e7153d12 showed [2c Ad 7s Qd] and lost with Ace-High
Seat 6: Hero showed [Qh Ac 9s Jc] and won ($0.11) with Pair of Jacks


Poker Hand #RC211925895: Omaha Pot Limit  ($0.01/$0.02) - 2022/10/21 12:38:16
Table 'RushAndCash1775895' 6-max Seat #1 is the button
Seat 1: Hero ($1.51 in chips)
Seat 2: 3be5e736 ($2.46 in chips)
Seat 3: 81b5c353 ($2 in chips)
Seat 4: 51d17ee8 ($2.09 in chips)
Seat 5: bd99a19d ($0.58 in chips)
Seat 6: 73e9cdad ($2.01 in chips)
3be5e736: posts small blind $0.01
81b5c353: posts big blind $0.02
*** HOLE CARDS ***
Dealt to Hero [4h Js 7h Qc]
Dealt to 3be5e736 
Dealt to 81b5c353 
Dealt to 51d17ee8 
Dealt to bd99a19d 
Dealt to 73e9cdad 
51d17ee8: folds
bd99a19d: folds
73e9cdad: folds
Hero: folds
3be5e736: folds
Uncalled bet ($0.01) returned to 81b5c353
*** SHOWDOWN ***
81b5c353 collected $0.02 from pot
*** SUMMARY ***
Total pot $0.02 | Rake $0 | Jackpot $0 | Bingo $0
Seat 1: Hero (button) folded before Flop (didn't bet)
Seat 2: 3be5e736 (small blind) folded before Flop
Seat 3: 81b5c353 (big blind) collected ($0.02)
Seat 4: 51d17ee8 folded before Flop (didn't bet)
Seat 5: bd99a19d folded before Flop (didn't bet)
Seat 6: 73e9cdad folded before Flop (didn't bet)


Poker Hand #RC211925886: Omaha Pot Limit  ($0.01/$0.02) - 2022/10/21 12:38:12
Table 'RushAndCash1775886' 6-max Seat #1 is the button
Seat 1: 73e9cdad ($2.01 in chips)
Seat 2: 5537777d ($2.77 in chips)
Seat 3: Hero ($1.53 in chips)
Seat 4: 51d17ee8 ($2.09 in chips)
Seat 5: cfbaf2a9 ($10.01 in chips)
Seat 6: 1eedbfa3 ($7.18 in chips)
5537777d: posts small blind $0.01
Hero: posts big blind $0.02
*** HOLE CARDS ***
Dealt to 73e9cdad 
Dealt to 5537777d 
Dealt to Hero [9s 5d Js Ts]
Dealt to 51d17ee8 
Dealt to cfbaf2a9 
Dealt to 1eedbfa3 
51d17ee8: folds
cfbaf2a9: folds
1eedbfa3: folds
73e9cdad: folds
5537777d: raises $0.04 to $0.06
Hero: folds
Uncalled bet ($0.04) returned to 5537777d
*** SHOWDOWN ***
5537777d collected $0.04 from pot
*** SUMMARY ***
Total pot $0.04 | Rake $0 | Jackpot $0 | Bingo $0
Seat 1: 73e9cdad (button) folded before Flop (didn't bet)
Seat 2: 5537777d (small blind) collected ($0.04)
Seat 3: Hero (big blind) folded before Flop
Seat 4: 51d17ee8 folded before Flop (didn't bet)
Seat 5: cfbaf2a9 folded before Flop (didn't bet)
Seat 6: 1eedbfa3 folded before Flop (didn't bet)


Poker Hand #RC211925877: Omaha Pot Limit  ($0.01/$0.02) - 2022/10/21 12:38:08
Table 'RushAndCash1775877' 6-max Seat #1 is the button
Seat 1: b7e67cac ($6.38 in chips)
Seat 2: Hero ($1.54 in chips)
Seat 3: e7153d12 ($0.37 in chips)
Seat 4: f254fa50 ($2 in chips)
Seat 5: 3be5e736 ($2.46 in chips)
Seat 6: 4ee6356f ($2.48 in chips)
Hero: posts small blind $0.01
e7153d12: posts big blind $0.02
*** HOLE CARDS ***
Dealt to b7e67cac 
Dealt to Hero [Th 9s 7c 5h]
Dealt to e7153d12 
Dealt to f254fa50 
Dealt to 3be5e736 
Dealt to 4ee6356f 
f254fa50: raises $0.05 to $0.07
3be5e736: folds
4ee6356f: folds
b7e67cac: folds
Hero: folds
e7153d12: folds
Uncalled bet ($0.05) returned to f254fa50
*** SHOWDOWN ***
f254fa50 collected $0.05 from pot
*** SUMMARY ***
Total pot $0.05 | Rake $0 | Jackpot $0 | Bingo $0
Seat 1: b7e67cac (button) folded before Flop (didn't bet)
Seat 2: Hero (small blind) folded before Flop
Seat 3: e7153d12 (big blind) folded before Flop
Seat 4: f254fa50 collected ($0.05)
Seat 5: 3be5e736 folded before Flop (didn't bet)
Seat 6: 4ee6356f folded before Flop (didn't bet)


Poker Hand #RC211925856: Omaha Pot Limit  ($0.01/$0.02) - 2022/10/21 12:37:58
Table 'RushAndCash1775856' 6-max Seat #1 is the button
Seat 1: 4ce2d7a0 ($2.88 in chips)
Seat 2: 6c5b1ad4 ($2.23 in chips)
Seat 3: 7badf949 ($4.66 in chips)
Seat 4: c9b9e9c8 ($2 in chips)
Seat 5: Hero ($1.54 in chips)
Seat 6: f09190e1 ($2.58 in chips)
6c5b1ad4: posts small blind $0.01
7badf949: posts big blind $0.02
*** HOLE CARDS ***
Dealt to 4ce2d7a0 
Dealt to 6c5b1ad4 
Dealt to 7badf949 
Dealt to c9b9e9c8 
Dealt to Hero [Jh 2s Jd Qh]
Dealt to f09190e1 
c9b9e9c8: folds
Hero: folds
f09190e1: raises $0.03 to $0.05
4ce2d7a0: folds
6c5b1ad4: folds
7badf949: folds
Uncalled bet ($0.03) returned to f09190e1
*** SHOWDOWN ***
f09190e1 collected $0.05 from pot
*** SUMMARY ***
Total pot $0.05 | Rake $0 | Jackpot $0 | Bingo $0
Seat 1: 4ce2d7a0 (button) folded before Flop (didn't bet)
Seat 2: 6c5b1ad4 (small blind) folded before Flop
Seat 3: 7badf949 (big blind) folded before Flop
Seat 4: c9b9e9c8 folded before Flop (didn't bet)
Seat 5: Hero folded before Flop (didn't bet)
Seat 6: f09190e1 collected ($0.05)


Poker Hand #RC211925839: Omaha Pot Limit  ($0.01/$0.02) - 2022/10/21 12:37:51
Table 'RushAndCash1775839' 6-max Seat #1 is the button
Seat 1: 39e105f9 ($2.27 in chips)
Seat 2: 89093cc5 ($2.01 in chips)
Seat 3: 86010f0f ($7.76 in chips)
Seat 4: a4e6fc19 ($1.99 in chips)
Seat 5: 4305b6c1 ($5.34 in chips)
Seat 6: Hero ($1.54 in chips)
89093cc5: posts small blind $0.01
86010f0f: posts big blind $0.02
*** HOLE CARDS ***
Dealt to 39e105f9 
Dealt to 89093cc5 
Dealt to 86010f0f 
Dealt to a4e6fc19 
Dealt to 4305b6c1 
Dealt to Hero [9d 2c 9h 4h]
a4e6fc19: folds
4305b6c1: folds
Hero: folds
39e105f9: raises $0.05 to $0.07
89093cc5: folds
86010f0f: folds
Uncalled bet ($0.05) returned to 39e105f9
*** SHOWDOWN ***
39e105f9 collected $0.05 from pot
*** SUMMARY ***
Total pot $0.05 | Rake $0 | Jackpot $0 | Bingo $0
Seat 1: 39e105f9 (button) collected ($0.05)
Seat 2: 89093cc5 (small blind) folded before Flop
Seat 3: 86010f0f (big blind) folded before Flop
Seat 4: a4e6fc19 folded before Flop (didn't bet)
Seat 5: 4305b6c1 folded before Flop (didn't bet)
Seat 6: Hero folded before Flop (didn't bet)


Poker Hand #RC211925831: Omaha Pot Limit  ($0.01/$0.02) - 2022/10/21 12:37:48
Table 'RushAndCash1775831' 6-max Seat #1 is the button
Seat 1: 5152aa00 ($2.08 in chips)
Seat 2: 5397c0b1 ($0.33 in chips)
Seat 3: 6f5c969f ($2.33 in chips)
Seat 4: a4e6fc19 ($1.99 in chips)
Seat 5: Hero ($1.54 in chips)
Seat 6: 4ee6356f ($2.48 in chips)
5397c0b1: posts small blind $0.01
6f5c969f: posts big blind $0.02
*** HOLE CARDS ***
Dealt to 5152aa00 
Dealt to 5397c0b1 
Dealt to 6f5c969f 
Dealt to a4e6fc19 
Dealt to Hero [Th 8s Qh 7c]
Dealt to 4ee6356f 
a4e6fc19: folds
Hero: folds
4ee6356f: folds
5152aa00: folds
5397c0b1: raises $0.04 to $0.06
6f5c969f: raises $0.1 to $0.16
5397c0b1: raises $0.17 to $0.33 and is all-in
6f5c969f: calls $0.17
5397c0b1: shows [Jc Kh 4h 6s]
6f5c969f: shows [As 6h Ts Jh]
*** FLOP *** [3s Kd Ad]
*** TURN *** [3s Kd Ad] [Qs]
*** RIVER *** [3s Kd Ad Qs] [Ac]
*** SHOWDOWN ***
6f5c969f collected $0.6 from pot
*** SUMMARY ***
Total pot $0.66 | Rake $0.03 | Jackpot $0.03 | Bingo $0
Board [3s Kd Ad Qs Ac]
Seat 1: 5152aa00 (button) folded before Flop (didn't bet)
Seat 2: 5397c0b1 (small blind) showed [Jc Kh 4h 6s] and lost with Pair of Aces and Pair of Kings
Seat 3: 6f5c969f (big blind) showed [As 6h Ts Jh] and won ($0.6) with Aces-High Straight
Seat 4: a4e6fc19 folded before Flop (didn't bet)
Seat 5: Hero folded before Flop (didn't bet)
Seat 6: 4ee6356f folded before Flop (didn't bet)


Poker Hand #RC211925819: Omaha Pot Limit  ($0.01/$0.02) - 2022/10/21 12:37:44
Table 'RushAndCash1775819' 6-max Seat #1 is the button
Seat 1: eae6d401 ($4.24 in chips)
Seat 2: Hero ($1.55 in chips)
Seat 3: 9b781057 ($2.39 in chips)
Seat 4: 4eefd3b ($2.7 in chips)
Seat 5: 5c4faaca ($4.07 in chips)
Seat 6: c9fdfd48 ($0.93 in chips)
Hero: posts small blind $0.01
9b781057: posts big blind $0.02
*** HOLE CARDS ***
Dealt to eae6d401 
Dealt to Hero [Js Th 4c Ad]
Dealt to 9b781057 
Dealt to 4eefd3b 
Dealt to 5c4faaca 
Dealt to c9fdfd48 
4eefd3b: raises $0.03 to $0.05
5c4faaca: folds
c9fdfd48: folds
eae6d401: folds
Hero: folds
9b781057: folds
Uncalled bet ($0.03) returned to 4eefd3b
*** SHOWDOWN ***
4eefd3b collected $0.05 from pot
*** SUMMARY ***
Total pot $0.05 | Rake $0 | Jackpot $0 | Bingo $0
Seat 1: eae6d401 (button) folded before Flop (didn't bet)
Seat 2: Hero (small blind) folded before Flop
Seat 3: 9b781057 (big blind) folded before Flop
Seat 4: 4eefd3b collected ($0.05)
Seat 5: 5c4faaca folded before Flop (didn't bet)
Seat 6: c9fdfd48 folded before Flop (didn't bet)


Poker Hand #RC211925764: Omaha Pot Limit  ($0.01/$0.02) - 2022/10/21 12:37:21
Table 'RushAndCash1775764' 6-max Seat #1 is the button
Seat 1: 5255aa86 ($2.5 in chips)
Seat 2: ca792926 ($2.04 in chips)
Seat 3: Hero ($1.61 in chips)
Seat 4: 4859f1fc ($7.46 in chips)
Seat 5: 4eefd3b ($2.63 in chips)
Seat 6: c0930254 ($2.08 in chips)
ca792926: posts small blind $0.01
Hero: posts big blind $0.02
*** HOLE CARDS ***
Dealt to 5255aa86 
Dealt to ca792926 
Dealt to Hero [5s Ad 6d 6c]
Dealt to 4859f1fc 
Dealt to 4eefd3b 
Dealt to c0930254 
4859f1fc: folds
4eefd3b: raises $0.04 to $0.06
c0930254: folds
5255aa86: folds
ca792926: folds
Hero: calls $0.04
*** FLOP *** [2s 5h 7h]
Hero: checks
4eefd3b: checks
*** TURN *** [2s 5h 7h] [Jd]
Hero: checks
4eefd3b: bets $0.08
Hero: folds
Uncalled bet ($0.08) returned to 4eefd3b
*** SHOWDOWN ***
4eefd3b collected $0.13 from pot
*** SUMMARY ***
Total pot $0.13 | Rake $0 | Jackpot $0 | Bingo $0
Board [2s 5h 7h Jd]
Seat 1: 5255aa86 (button) folded before Flop (didn't bet)
Seat 2: ca792926 (small blind) folded before Flop
Seat 3: Hero (big blind) folded on the Turn
Seat 4: 4859f1fc folded before Flop (didn't bet)
Seat 5: 4eefd3b won ($0.13)
Seat 6: c0930254 folded before Flop (didn't bet)


Poker Hand #RC211925754: Omaha Pot Limit  ($0.01/$0.02) - 2022/10/21 12:37:16
Table 'RushAndCash1775754' 6-max Seat #1 is the button
Seat 1: c3e9555e ($1.96 in chips)
Seat 2: a2ca86df ($2.09 in chips)
Seat 3: 8231173d ($2 in chips)
Seat 4: 38ddecaa ($1.42 in chips)
Seat 5: a30ea4fe ($2.35 in chips)
Seat 6: Hero ($1.61 in chips)
a2ca86df: posts small blind $0.01
8231173d: posts big blind $0.02
*** HOLE CARDS ***
Dealt to c3e9555e 
Dealt to a2ca86df 
Dealt to 8231173d 
Dealt to 38ddecaa 
Dealt to a30ea4fe 
Dealt to Hero [Js Th 2h 7s]
38ddecaa: raises $0.02 to $0.04
a30ea4fe: folds
Hero: folds
c3e9555e: folds
a2ca86df: calls $0.03
8231173d: folds
*** FLOP *** [Qh 8c 9s]
a2ca86df: bets $0.1
38ddecaa: folds
Uncalled bet ($0.1) returned to a2ca86df
*** SHOWDOWN ***
a2ca86df collected $0.1 from pot
*** SUMMARY ***
Total pot $0.1 | Rake $0 | Jackpot $0 | Bingo $0
Board [Qh 8c 9s]
Seat 1: c3e9555e (button) folded before Flop (didn't bet)
Seat 2: a2ca86df (small blind) won ($0.1)
Seat 3: 8231173d (big blind) folded before Flop
Seat 4: 38ddecaa folded on the Flop
Seat 5: a30ea4fe folded before Flop (didn't bet)
Seat 6: Hero folded before Flop (didn't bet)


Poker Hand #RC211925743: Omaha Pot Limit  ($0.01/$0.02) - 2022/10/21 12:37:13
Table 'RushAndCash1775743' 6-max Seat #1 is the button
Seat 1: 6d9970e3 ($2 in chips)
Seat 2: ab9b72d9 ($2.18 in chips)
Seat 3: 6f5c969f ($2.4 in chips)
Seat 4: 7badf949 ($4.64 in chips)
Seat 5: 4ee6356f ($2.4 in chips)
Seat 6: Hero ($1.61 in chips)
ab9b72d9: posts small blind $0.01
6f5c969f: posts big blind $0.02
*** HOLE CARDS ***
Dealt to 6d9970e3 
Dealt to ab9b72d9 
Dealt to 6f5c969f 
Dealt to 7badf949 
Dealt to 4ee6356f 
Dealt to Hero [7h 2s 2d Ac]
7badf949: folds
4ee6356f: raises $0.05 to $0.07
Hero: folds
6d9970e3: folds
ab9b72d9: folds
6f5c969f: calls $0.05
*** FLOP *** [Jd 7s 5s]
6f5c969f: checks
4ee6356f: bets $0.12
6f5c969f: folds
Uncalled bet ($0.12) returned to 4ee6356f
*** SHOWDOWN ***
4ee6356f collected $0.15 from pot
*** SUMMARY ***
Total pot $0.15 | Rake $0 | Jackpot $0 | Bingo $0
Board [Jd 7s 5s]
Seat 1: 6d9970e3 (button) folded before Flop (didn't bet)
Seat 2: ab9b72d9 (small blind) folded before Flop
Seat 3: 6f5c969f (big blind) folded on the Flop
Seat 4: 7badf949 folded before Flop (didn't bet)
Seat 5: 4ee6356f won ($0.15)
Seat 6: Hero folded before Flop (didn't bet)


Poker Hand #RC211925734: Omaha Pot Limit  ($0.01/$0.02) - 2022/10/21 12:37:09
Table 'RushAndCash1775734' 6-max Seat #1 is the button
Seat 1: Hero ($1.61 in chips)
Seat 2: 16be129e ($3.11 in chips)
Seat 3: c0930254 ($2.1 in chips)
Seat 4: 4beb7f7c ($3.08 in chips)
Seat 5: 6d9970e3 ($2 in chips)
Seat 6: f5524b6e ($2.03 in chips)
16be129e: posts small blind $0.01
c0930254: posts big blind $0.02
*** HOLE CARDS ***
Dealt to Hero [Ac 2d 5s Qd]
Dealt to 16be129e 
Dealt to c0930254 
Dealt to 4beb7f7c 
Dealt to 6d9970e3 
Dealt to f5524b6e 
4beb7f7c: folds
6d9970e3: folds
f5524b6e: raises $0.05 to $0.07
Hero: folds
16be129e: folds
c0930254: folds
Uncalled bet ($0.05) returned to f5524b6e
*** SHOWDOWN ***
f5524b6e collected $0.05 from pot
*** SUMMARY ***
Total pot $0.05 | Rake $0 | Jackpot $0 | Bingo $0
Seat 1: Hero (button) folded before Flop (didn't bet)
Seat 2: 16be129e (small blind) folded before Flop
Seat 3: c0930254 (big blind) folded before Flop
Seat 4: 4beb7f7c folded before Flop (didn't bet)
Seat 5: 6d9970e3 folded before Flop (didn't bet)
Seat 6: f5524b6e collected ($0.05)


Poker Hand #RC211925726: Omaha Pot Limit  ($0.01/$0.02) - 2022/10/21 12:37:06
Table 'RushAndCash1775726' 6-max Seat #1 is the button
Seat 1: d6d38d86 ($1.95 in chips)
Seat 2: dad21c5a ($2 in chips)
Seat 3: 5d4cd06b ($2.12 in chips)
Seat 4: c0930254 ($2.1 in chips)
Seat 5: 612276db ($2.02 in chips)
Seat 6: Hero ($1.61 in chips)
dad21c5a: posts small blind $0.01
5d4cd06b: posts big blind $0.02
*** HOLE CARDS ***
Dealt to d6d38d86 
Dealt to dad21c5a 
Dealt to 5d4cd06b 
Dealt to c0930254 
Dealt to 612276db 
Dealt to Hero [8d 7s 9h Kd]
c0930254: folds
612276db: folds
Hero: folds
d6d38d86: raises $0.02 to $0.04
dad21c5a: folds
5d4cd06b: calls $0.02
*** FLOP *** [8h 9c 5h]
5d4cd06b: checks
d6d38d86: bets $0.06
5d4cd06b: folds
Uncalled bet ($0.06) returned to d6d38d86
*** SHOWDOWN ***
d6d38d86 collected $0.09 from pot
*** SUMMARY ***
Total pot $0.09 | Rake $0 | Jackpot $0 | Bingo $0
Board [8h 9c 5h]
Seat 1: d6d38d86 (button) won ($0.09)
Seat 2: dad21c5a (small blind) folded before Flop
Seat 3: 5d4cd06b (big blind) folded on the Flop
Seat 4: c0930254 folded before Flop (didn't bet)
Seat 5: 612276db folded before Flop (didn't bet)
Seat 6: Hero folded before Flop (didn't bet)


Poker Hand #RC211925718: Omaha Pot Limit  ($0.01/$0.02) - 2022/10/21 12:37:02
Table 'RushAndCash1775718' 6-max Seat #1 is the button
Seat 1: 1e9ff1cd ($3.26 in chips)
Seat 2: 1cecdaa3 ($3.51 in chips)
Seat 3: 86010f0f ($7.82 in chips)
Seat 4: Hero ($1.61 in chips)
Seat 5: a978283b ($0.27 in chips)
Seat 6: db5462ed ($4.83 in chips)
1cecdaa3: posts small blind $0.01
86010f0f: posts big blind $0.02
*** HOLE CARDS ***
Dealt to 1e9ff1cd 
Dealt to 1cecdaa3 
Dealt to 86010f0f 
Dealt to Hero [8s Kd 4c Td]
Dealt to a978283b 
Dealt to db5462ed 
Hero: folds
a978283b: raises $0.02 to $0.04
db5462ed: folds
1e9ff1cd: folds
1cecdaa3: folds
86010f0f: folds
Uncalled bet ($0.02) returned to a978283b
*** SHOWDOWN ***
a978283b collected $0.05 from pot
*** SUMMARY ***
Total pot $0.05 | Rake $0 | Jackpot $0 | Bingo $0
Seat 1: 1e9ff1cd (button) folded before Flop (didn't bet)
Seat 2: 1cecdaa3 (small blind) folded before Flop
Seat 3: 86010f0f (big blind) folded before Flop
Seat 4: Hero folded before Flop (didn't bet)
Seat 5: a978283b collected ($0.05)
Seat 6: db5462ed folded before Flop (didn't bet)


Poker Hand #RC211925708: Omaha Pot Limit  ($0.01/$0.02) - 2022/10/21 12:36:57
Table 'RushAndCash1775708' 6-max Seat #1 is the button
Seat 1: db5462ed ($4.83 in chips)
Seat 2: Hero ($1.62 in chips)
Seat 3: cc313f25 ($4.76 in chips)
Seat 4: 86010f0f ($7.82 in chips)
Seat 5: 45549b8b ($4.48 in chips)
Seat 6: 6f5c969f ($2.4 in chips)
Hero: posts small blind $0.01
cc313f25: posts big blind $0.02
*** HOLE CARDS ***
Dealt to db5462ed 
Dealt to Hero [7c 5c Ks Qc]
Dealt to cc313f25 
Dealt to 86010f0f 
Dealt to 45549b8b 
Dealt to 6f5c969f 
86010f0f: folds
45549b8b: raises $0.04 to $0.06
6f5c969f: folds
db5462ed: folds
Hero: folds
cc313f25: folds
Uncalled bet ($0.04) returned to 45549b8b
*** SHOWDOWN ***
45549b8b collected $0.05 from pot
*** SUMMARY ***
Total pot $0.05 | Rake $0 | Jackpot $0 | Bingo $0
Seat 1: db5462ed (button) folded before Flop (didn't bet)
Seat 2: Hero (small blind) folded before Flop
Seat 3: cc313f25 (big blind) folded before Flop
Seat 4: 86010f0f folded before Flop (didn't bet)
Seat 5: 45549b8b collected ($0.05)
Seat 6: 6f5c969f folded before Flop (didn't bet)


Poker Hand #RC211925700: Omaha Pot Limit  ($0.01/$0.02) - 2022/10/21 12:36:53
Table 'RushAndCash1775700' 6-max Seat #1 is the button
Seat 1: 1a8ba4a ($10.96 in chips)
Seat 2: a62396a8 ($1.06 in chips)
Seat 3: Hero ($1.64 in chips)
Seat 4: 419bbbaf ($2.07 in chips)
Seat 5: 6a90d83f ($2.66 in chips)
Seat 6: a00fec6e ($2 in chips)
a62396a8: posts small blind $0.01
Hero: posts big blind $0.02
*** HOLE CARDS ***
Dealt to 1a8ba4a 
Dealt to a62396a8 
Dealt to Hero [9c Qs 7d 7h]
Dealt to 419bbbaf 
Dealt to 6a90d83f 
Dealt to a00fec6e 
419bbbaf: raises $0.05 to $0.07
6a90d83f: calls $0.07
a00fec6e: folds
1a8ba4a: folds
a62396a8: folds
Hero: folds
*** FLOP *** [Jh Jc Ah]
419bbbaf: checks
6a90d83f: checks
*** TURN *** [Jh Jc Ah] [As]
419bbbaf: checks
6a90d83f: checks
*** RIVER *** [Jh Jc Ah As] [Td]
419bbbaf: checks
6a90d83f: checks
419bbbaf: shows [Kh Tc 9s Ks] (Pair of Aces and Pair of Kings)
6a90d83f: shows [Qd Qh 8h 2d] (Pair of Aces and Pair of Queens)
*** SHOWDOWN ***
419bbbaf collected $0.16 from pot
*** SUMMARY ***
Total pot $0.17 | Rake $0.01 | Jackpot $0 | Bingo $0
Board [Jh Jc Ah As Td]
Seat 1: 1a8ba4a (button) folded before Flop (didn't bet)
Seat 2: a62396a8 (small blind) folded before Flop
Seat 3: Hero (big blind) folded before Flop
Seat 4: 419bbbaf showed [Kh Tc 9s Ks] and won ($0.16) with Pair of Aces and Pair of Kings
Seat 5: 6a90d83f showed [Qd Qh 8h 2d] and lost with Pair of Aces and Pair of Queens
Seat 6: a00fec6e folded before Flop (didn't bet)


Poker Hand #RC211925692: Omaha Pot Limit  ($0.01/$0.02) - 2022/10/21 12:36:50
Table 'RushAndCash1775692' 6-max Seat #1 is the button
Seat 1: Hero ($1.64 in chips)
Seat 2: 3391c12a ($2.97 in chips)
Seat 3: 98a1ebf0 ($2.65 in chips)
Seat 4: 185ba609 ($12.37 in chips)
Seat 5: 17c11c29 ($2.75 in chips)
Seat 6: 98aef212 ($3.08 in chips)
3391c12a: posts small blind $0.01
98a1ebf0: posts big blind $0.02
*** HOLE CARDS ***
Dealt to Hero [4h Kd 5d 8h]
Dealt to 3391c12a 
Dealt to 98a1ebf0 
Dealt to 185ba609 
Dealt to 17c11c29 
Dealt to 98aef212 
185ba609: raises $0.04 to $0.06
17c11c29: folds
98aef212: folds
Hero: folds
3391c12a: folds
98a1ebf0: folds
Uncalled bet ($0.04) returned to 185ba609
*** SHOWDOWN ***
185ba609 collected $0.05 from pot
*** SUMMARY ***
Total pot $0.05 | Rake $0 | Jackpot $0 | Bingo $0
Seat 1: Hero (button) folded before Flop (didn't bet)
Seat 2: 3391c12a (small blind) folded before Flop
Seat 3: 98a1ebf0 (big blind) folded before Flop
Seat 4: 185ba609 collected ($0.05)
Seat 5: 17c11c29 folded before Flop (didn't bet)
Seat 6: 98aef212 folded before Flop (didn't bet)


Poker Hand #RC211925681: Omaha Pot Limit  ($0.01/$0.02) - 2022/10/21 12:36:46
Table 'RushAndCash1775681' 6-max Seat #1 is the button
Seat 1: ba900941 ($2.03 in chips)
Seat 2: c9fdfd48 ($0.8 in chips)
Seat 3: bc70dc6 ($2.98 in chips)
Seat 4: 17c11c29 ($2.75 in chips)
Seat 5: 185ba609 ($12.37 in chips)
Seat 6: Hero ($1.64 in chips)
c9fdfd48: posts small blind $0.01
bc70dc6: posts big blind $0.02
*** HOLE CARDS ***
Dealt to ba900941 
Dealt to c9fdfd48 
Dealt to bc70dc6 
Dealt to 17c11c29 
Dealt to 185ba609 
Dealt to Hero [3s Tc Ac 4h]
17c11c29: folds
185ba609: folds
Hero: folds
ba900941: raises $0.05 to $0.07
c9fdfd48: calls $0.06
bc70dc6: calls $0.05
*** FLOP *** [6s 7s Jd]
c9fdfd48: checks
bc70dc6: checks
ba900941: checks
*** TURN *** [6s 7s Jd] [9h]
c9fdfd48: bets $0.21
bc70dc6: folds
ba900941: folds
Uncalled bet ($0.21) returned to c9fdfd48
*** SHOWDOWN ***
c9fdfd48 collected $0.2 from pot
*** SUMMARY ***
Total pot $0.21 | Rake $0.01 | Jackpot $0 | Bingo $0
Board [6s 7s Jd 9h]
Seat 1: ba900941 (button) folded on the Turn
Seat 2: c9fdfd48 (small blind) won ($0.2)
Seat 3: bc70dc6 (big blind) folded on the Turn
Seat 4: 17c11c29 folded before Flop (didn't bet)
Seat 5: 185ba609 folded before Flop (didn't bet)
Seat 6: Hero folded before Flop (didn't bet)


Poker Hand #RC211925674: Omaha Pot Limit  ($0.01/$0.02) - 2022/10/21 12:36:42
Table 'RushAndCash1775674' 6-max Seat #1 is the button
Seat 1: 185ba609 ($12.37 in chips)
Seat 2: 7cf97e5c ($2 in chips)
Seat 3: 98aef212 ($3.1 in chips)
Seat 4: Hero ($1.61 in chips)
Seat 5: 4eefd3b ($2.64 in chips)
Seat 6: 85e58b19 ($6.47 in chips)
7cf97e5c: posts small blind $0.01
98aef212: posts big blind $0.02
*** HOLE CARDS ***
Dealt to 185ba609 
Dealt to 7cf97e5c 
Dealt to 98aef212 
Dealt to Hero [5h 2d 5c Qd]
Dealt to 4eefd3b 
Dealt to 85e58b19 
Hero: folds
4eefd3b: raises $0.05 to $0.07
85e58b19: folds
185ba609: folds
7cf97e5c: folds
98aef212: folds
Uncalled bet ($0.05) returned to 4eefd3b
*** SHOWDOWN ***
4eefd3b collected $0.05 from pot
*** SUMMARY ***
Total pot $0.05 | Rake $0 | Jackpot $0 | Bingo $0
Seat 1: 185ba609 (button) folded before Flop (didn't bet)
Seat 2: 7cf97e5c (small blind) folded before Flop
Seat 3: 98aef212 (big blind) folded before Flop
Seat 4: Hero folded before Flop (didn't bet)
Seat 5: 4eefd3b collected ($0.05)
Seat 6: 85e58b19 folded before Flop (didn't bet)


Poker Hand #RC211925665: Omaha Pot Limit  ($0.01/$0.02) - 2022/10/21 12:36:38
Table 'RushAndCash1775665' 6-max Seat #1 is the button
Seat 1: 8cb8a924 ($4.32 in chips)
Seat 2: f01d5deb ($5.33 in chips)
Seat 3: 799f4168 ($1.97 in chips)
Seat 4: Hero ($1.61 in chips)
Seat 5: 60c62cbf ($4.86 in chips)
Seat 6: bb360fb3 ($0.61 in chips)
f01d5deb: posts small blind $0.01
799f4168: posts big blind $0.02
*** HOLE CARDS ***
Dealt to 8cb8a924 
Dealt to f01d5deb 
Dealt to 799f4168 
Dealt to Hero [7d Ah 8d Js]
Dealt to 60c62cbf 
Dealt to bb360fb3 
Hero: folds
60c62cbf: raises $0.02 to $0.04
bb360fb3: calls $0.04
8cb8a924: folds
f01d5deb: folds
799f4168: raises $0.13 to $0.17
60c62cbf: folds
bb360fb3: calls $0.13
*** FLOP *** [2h Kc 7c]
799f4168: bets $0.39
bb360fb3: raises $0.05 to $0.44 and is all-in
799f4168: calls $0.05
bb360fb3: shows [5s 7s Ks Kh] (Three Kings)
799f4168: shows [Ad As Td Jh] (Pair of Aces)
*** TURN *** [2h Kc 7c] [Ac]
799f4168: Chooses to EV Cashout 
*** RIVER *** [2h Kc 7c Ac] [4d]
799f4168: Pays Cashout Risk ($0.05)
*** SHOWDOWN ***
799f4168 collected $1.18 from pot
*** SUMMARY ***
Total pot $1.27 | Rake $0.06 | Jackpot $0.03 | Bingo $0
Board [2h Kc 7c Ac 4d]
Seat 1: 8cb8a924 (button) folded before Flop (didn't bet)
Seat 2: f01d5deb (small blind) folded before Flop
Seat 3: 799f4168 (big blind) showed [Ad As Td Jh] and won ($1.18) with Three Aces, Cashout Risk ($0.05)
Seat 4: Hero folded before Flop (didn't bet)
Seat 5: 60c62cbf folded before Flop
Seat 6: bb360fb3 showed [5s 7s Ks Kh] and lost with Three Kings


Poker Hand #RC211925656: Omaha Pot Limit  ($0.01/$0.02) - 2022/10/21 12:36:34
Table 'RushAndCash1775656' 6-max Seat #1 is the button
Seat 1: f01d5deb ($5.33 in chips)
Seat 2: Hero ($1.62 in chips)
Seat 3: 7cc03d50 ($2 in chips)
Seat 4: db5462ed ($4.86 in chips)
Seat 5: f41cec53 ($3.14 in chips)
Seat 6: bb360fb3 ($0.61 in chips)
Hero: posts small blind $0.01
7cc03d50: posts big blind $0.02
*** HOLE CARDS ***
Dealt to f01d5deb 
Dealt to Hero [Qd Qc Jd 9d]
Dealt to 7cc03d50 
Dealt to db5462ed 
Dealt to f41cec53 
Dealt to bb360fb3 
db5462ed: folds
f41cec53: folds
bb360fb3: folds
f01d5deb: folds
Hero: folds
Uncalled bet ($0.01) returned to 7cc03d50
*** SHOWDOWN ***
7cc03d50 collected $0.02 from pot
*** SUMMARY ***
Total pot $0.02 | Rake $0 | Jackpot $0 | Bingo $0
Seat 1: f01d5deb (button) folded before Flop (didn't bet)
Seat 2: Hero (small blind) folded before Flop
Seat 3: 7cc03d50 (big blind) collected ($0.02)
Seat 4: db5462ed folded before Flop (didn't bet)
Seat 5: f41cec53 folded before Flop (didn't bet)
Seat 6: bb360fb3 folded before Flop (didn't bet)


Poker Hand #RC211925649: Omaha Pot Limit  ($0.01/$0.02) - 2022/10/21 12:36:31
Table 'RushAndCash1775649' 6-max Seat #1 is the button
Seat 1: 16be129e ($3.13 in chips)
Seat 2: 85e58b19 ($6.5 in chips)
Seat 3: Hero ($1.64 in chips)
Seat 4: da0ce77b ($2.02 in chips)
Seat 5: f5de8664 ($2.24 in chips)
Seat 6: 971ded4e ($2.48 in chips)
85e58b19: posts small blind $0.01
Hero: posts big blind $0.02
*** HOLE CARDS ***
Dealt to 16be129e 
Dealt to 85e58b19 
Dealt to Hero [5h 4c 6c 7s]
Dealt to da0ce77b 
Dealt to f5de8664 
Dealt to 971ded4e 
da0ce77b: folds
f5de8664: folds
971ded4e: folds
16be129e: folds
85e58b19: folds
Uncalled bet ($0.01) returned to Hero
*** SHOWDOWN ***
Hero collected $0.02 from pot
*** SUMMARY ***
Total pot $0.02 | Rake $0 | Jackpot $0 | Bingo $0
Seat 1: 16be129e (button) folded before Flop (didn't bet)
Seat 2: 85e58b19 (small blind) folded before Flop
Seat 3: Hero (big blind) collected ($0.02)
Seat 4: da0ce77b folded before Flop (didn't bet)
Seat 5: f5de8664 folded before Flop (didn't bet)
Seat 6: 971ded4e folded before Flop (didn't bet)


Poker Hand #RC211925643: Omaha Pot Limit  ($0.01/$0.02) - 2022/10/21 12:36:26
Table 'RushAndCash1775643' 6-max Seat #1 is the button
Seat 1: Hero ($1.64 in chips)
Seat 2: cd9739d7 ($2 in chips)
Seat 3: 792e227 ($15.06 in chips)
Seat 4: ec497a2f ($2 in chips)
Seat 5: c9fdfd48 ($0.79 in chips)
Seat 6: 7cc03d50 ($2 in chips)
cd9739d7: posts small blind $0.01
792e227: posts big blind $0.02
*** HOLE CARDS ***
Dealt to Hero [Ad 8s Qc 4d]
Dealt to cd9739d7 
Dealt to 792e227 
Dealt to ec497a2f 
Dealt to c9fdfd48 
Dealt to 7cc03d50 
ec497a2f: folds
c9fdfd48: folds
7cc03d50: folds
Hero: folds
cd9739d7: folds
Uncalled bet ($0.01) returned to 792e227
*** SHOWDOWN ***
792e227 collected $0.02 from pot
*** SUMMARY ***
Total pot $0.02 | Rake $0 | Jackpot $0 | Bingo $0
Seat 1: Hero (button) folded before Flop (didn't bet)
Seat 2: cd9739d7 (small blind) folded before Flop
Seat 3: 792e227 (big blind) collected ($0.02)
Seat 4: ec497a2f folded before Flop (didn't bet)
Seat 5: c9fdfd48 folded before Flop (didn't bet)
Seat 6: 7cc03d50 folded before Flop (didn't bet)


Poker Hand #RC211925634: Omaha Pot Limit  ($0.01/$0.02) - 2022/10/21 12:36:23
Table 'RushAndCash1775634' 6-max Seat #1 is the button
Seat 1: 6bebea35 ($2 in chips)
Seat 2: Hero ($1.65 in chips)
Seat 3: 4eefd3b ($2.63 in chips)
Seat 4: 65af0a69 ($1.06 in chips)
Seat 5: da0ce77b ($2.02 in chips)
Seat 6: 3381ab97 ($2.33 in chips)
Hero: posts small blind $0.01
4eefd3b: posts big blind $0.02
*** HOLE CARDS ***
Dealt to 6bebea35 
Dealt to Hero [9s 7s 5s Qd]
Dealt to 4eefd3b 
Dealt to 65af0a69 
Dealt to da0ce77b 
Dealt to 3381ab97 
65af0a69: folds
da0ce77b: folds
3381ab97: folds
6bebea35: folds
Hero: folds
Uncalled bet ($0.01) returned to 4eefd3b
*** SHOWDOWN ***
4eefd3b collected $0.02 from pot
*** SUMMARY ***
Total pot $0.02 | Rake $0 | Jackpot $0 | Bingo $0
Seat 1: 6bebea35 (button) folded before Flop (didn't bet)
Seat 2: Hero (small blind) folded before Flop
Seat 3: 4eefd3b (big blind) collected ($0.02)
Seat 4: 65af0a69 folded before Flop (didn't bet)
Seat 5: da0ce77b folded before Flop (didn't bet)
Seat 6: 3381ab97 folded before Flop (didn't bet)


Poker Hand #RC211925629: Omaha Pot Limit  ($0.01/$0.02) - 2022/10/21 12:36:20
Table 'RushAndCash1775629' 6-max Seat #1 is the button
Seat 1: f23f8f77 ($0.45 in chips)
Seat 2: 5900bc4f ($2.29 in chips)
Seat 3: f01d5deb ($5.35 in chips)
Seat 4: afb3ead0 ($3.41 in chips)
Seat 5: Hero ($1.65 in chips)
Seat 6: 1c37a64d ($0.8 in chips)
5900bc4f: posts small blind $0.01
f01d5deb: posts big blind $0.02
*** HOLE CARDS ***
Dealt to f23f8f77 
Dealt to 5900bc4f 
Dealt to f01d5deb 
Dealt to afb3ead0 
Dealt to Hero [2h 7d 5d Ts]
Dealt to 1c37a64d 
afb3ead0: raises $0.05 to $0.07
Hero: folds
1c37a64d: folds
f23f8f77: folds
5900bc4f: folds
f01d5deb: folds
Uncalled bet ($0.05) returned to afb3ead0
*** SHOWDOWN ***
afb3ead0 collected $0.05 from pot
*** SUMMARY ***
Total pot $0.05 | Rake $0 | Jackpot $0 | Bingo $0
Seat 1: f23f8f77 (button) folded before Flop (didn't bet)
Seat 2: 5900bc4f (small blind) folded before Flop
Seat 3: f01d5deb (big blind) folded before Flop
Seat 4: afb3ead0 collected ($0.05)
Seat 5: Hero folded before Flop (didn't bet)
Seat 6: 1c37a64d folded before Flop (didn't bet)


Poker Hand #RC211925623: Omaha Pot Limit  ($0.01/$0.02) - 2022/10/21 12:36:16
Table 'RushAndCash1775623' 6-max Seat #1 is the button
Seat 1: a97e602d ($2.37 in chips)
Seat 2: 5152aa00 ($2.09 in chips)
Seat 3: Hero ($1.67 in chips)
Seat 4: 3391c12a ($2.96 in chips)
Seat 5: 85e58b19 ($6.5 in chips)
Seat 6: aafcfc55 ($2 in chips)
5152aa00: posts small blind $0.01
Hero: posts big blind $0.02
*** HOLE CARDS ***
Dealt to a97e602d 
Dealt to 5152aa00 
Dealt to Hero [4h 8s 3d 6h]
Dealt to 3391c12a 
Dealt to 85e58b19 
Dealt to aafcfc55 
3391c12a: folds
85e58b19: folds
aafcfc55: folds
a97e602d: folds
5152aa00: raises $0.04 to $0.06
Hero: folds
Uncalled bet ($0.04) returned to 5152aa00
*** SHOWDOWN ***
5152aa00 collected $0.04 from pot
*** SUMMARY ***
Total pot $0.04 | Rake $0 | Jackpot $0 | Bingo $0
Seat 1: a97e602d (button) folded before Flop (didn't bet)
Seat 2: 5152aa00 (small blind) collected ($0.04)
Seat 3: Hero (big blind) folded before Flop
Seat 4: 3391c12a folded before Flop (didn't bet)
Seat 5: 85e58b19 folded before Flop (didn't bet)
Seat 6: aafcfc55 folded before Flop (didn't bet)


Poker Hand #RC211925477: Omaha Pot Limit  ($0.01/$0.02) - 2022/10/21 12:35:06
Table 'RushAndCash1775477' 6-max Seat #1 is the button
Seat 1: Hero ($1.19 in chips)
Seat 2: aafcfc55 ($2.42 in chips)
Seat 3: efa6db66 ($2.19 in chips)
Seat 4: 1eedbfa3 ($7.27 in chips)
Seat 5: 2c413280 ($2.67 in chips)
Seat 6: 8537a603 ($2.08 in chips)
aafcfc55: posts small blind $0.01
efa6db66: posts big blind $0.02
*** HOLE CARDS ***
Dealt to Hero [Js Ac Ad 2s]
Dealt to aafcfc55 
Dealt to efa6db66 
Dealt to 1eedbfa3 
Dealt to 2c413280 
Dealt to 8537a603 
1eedbfa3: folds
2c413280: raises $0.05 to $0.07
8537a603: folds
Hero: calls $0.07
aafcfc55: raises $0.23 to $0.3
efa6db66: folds
2c413280: calls $0.23
Hero: raises $0.89 to $1.19 and is all-in
aafcfc55: calls $0.89
2c413280: folds
Hero: shows [Js Ac Ad 2s]
aafcfc55: shows [8c Qd Jc 9h]
*** FLOP *** [8d Ts 6h]
*** TURN *** [8d Ts 6h] [5h]
Hero: Chooses to EV Cashout 
*** RIVER *** [8d Ts 6h 5h] [4s]
Hero: Pays Cashout Risk ($0.94)
*** SHOWDOWN ***
Hero collected $2.61 from pot
*** SUMMARY ***
Total pot $2.7 | Rake $0.06 | Jackpot $0.03 | Bingo $0
Board [8d Ts 6h 5h 4s]
Seat 1: Hero (button) showed [Js Ac Ad 2s] and won ($2.61) with Pair of Aces, Cashout Risk ($0.94)
Seat 2: aafcfc55 (small blind) showed [8c Qd Jc 9h] and lost with Pair of Eights
Seat 3: efa6db66 (big blind) folded before Flop
Seat 4: 1eedbfa3 folded before Flop (didn't bet)
Seat 5: 2c413280 folded before Flop
Seat 6: 8537a603 folded before Flop (didn't bet)


Poker Hand #RC211925471: Omaha Pot Limit  ($0.01/$0.02) - 2022/10/21 12:35:02
Table 'RushAndCash1775471' 6-max Seat #1 is the button
Seat 1: 8537a603 ($2.08 in chips)
Seat 2: a00fec6e ($2 in chips)
Seat 3: 17c11c29 ($2.47 in chips)
Seat 4: 1eedbfa3 ($7.27 in chips)
Seat 5: Hero ($1.19 in chips)
Seat 6: c0930254 ($2 in chips)
a00fec6e: posts small blind $0.01
17c11c29: posts big blind $0.02
*** HOLE CARDS ***
Dealt to 8537a603 
Dealt to a00fec6e 
Dealt to 17c11c29 
Dealt to 1eedbfa3 
Dealt to Hero [Tc 2h 3s Qs]
Dealt to c0930254 
1eedbfa3: folds
Hero: folds
c0930254: folds
8537a603: folds
a00fec6e: raises $0.04 to $0.06
17c11c29: raises $0.12 to $0.18
a00fec6e: calls $0.12
*** FLOP *** [4h 8d 7d]
a00fec6e: checks
17c11c29: checks
*** TURN *** [4h 8d 7d] [3h]
a00fec6e: checks
17c11c29: bets $0.2
a00fec6e: calls $0.2
*** RIVER *** [4h 8d 7d 3h] [Ad]
a00fec6e: checks
17c11c29: checks
a00fec6e: shows [9h 6c Jc 6h] (Pair of Sixes)
17c11c29: shows [Qh Kh Ks 9s] (Pair of Kings)
*** SHOWDOWN ***
17c11c29 collected $0.7 from pot
*** SUMMARY ***
Total pot $0.76 | Rake $0.03 | Jackpot $0.03 | Bingo $0
Board [4h 8d 7d 3h Ad]
Seat 1: 8537a603 (button) folded before Flop (didn't bet)
Seat 2: a00fec6e (small blind) showed [9h 6c Jc 6h] and lost with Pair of Sixes
Seat 3: 17c11c29 (big blind) showed [Qh Kh Ks 9s] and won ($0.7) with Pair of Kings
Seat 4: 1eedbfa3 folded before Flop (didn't bet)
Seat 5: Hero folded before Flop (didn't bet)
Seat 6: c0930254 folded before Flop (didn't bet)


Poker Hand #RC211925464: Omaha Pot Limit  ($0.01/$0.02) - 2022/10/21 12:34:59
Table 'RushAndCash1775464' 6-max Seat #1 is the button
Seat 1: 847618dc ($2.15 in chips)
Seat 2: bb360fb3 ($0.71 in chips)
Seat 3: 1eedbfa3 ($7.29 in chips)
Seat 4: aa989090 ($2.07 in chips)
Seat 5: 12a83aff ($1.25 in chips)
Seat 6: Hero ($1.19 in chips)
bb360fb3: posts small blind $0.01
1eedbfa3: posts big blind $0.02
*** HOLE CARDS ***
Dealt to 847618dc 
Dealt to bb360fb3 
Dealt to 1eedbfa3 
Dealt to aa989090 
Dealt to 12a83aff 
Dealt to Hero [8h 3s Qs 7d]
aa989090: folds
12a83aff: raises $0.04 to $0.06
Hero: folds
847618dc: folds
bb360fb3: folds
1eedbfa3: folds
Uncalled bet ($0.04) returned to 12a83aff
*** SHOWDOWN ***
12a83aff collected $0.05 from pot
*** SUMMARY ***
Total pot $0.05 | Rake $0 | Jackpot $0 | Bingo $0
Seat 1: 847618dc (button) folded before Flop (didn't bet)
Seat 2: bb360fb3 (small blind) folded before Flop
Seat 3: 1eedbfa3 (big blind) folded before Flop
Seat 4: aa989090 folded before Flop (didn't bet)
Seat 5: 12a83aff collected ($0.05)
Seat 6: Hero folded before Flop (didn't bet)


Poker Hand #RC211925455: Omaha Pot Limit  ($0.01/$0.02) - 2022/10/21 12:34:54
Table 'RushAndCash1775455' 6-max Seat #1 is the button
Seat 1: 185ba609 ($12.65 in chips)
Seat 2: 1a8ba4a ($10.99 in chips)
Seat 3: 7d123dda ($2.24 in chips)
Seat 4: 65af0a69 ($0.82 in chips)
Seat 5: Hero ($1.19 in chips)
Seat 6: 5c0df65c ($2 in chips)
1a8ba4a: posts small blind $0.01
7d123dda: posts big blind $0.02
*** HOLE CARDS ***
Dealt to 185ba609 
Dealt to 1a8ba4a 
Dealt to 7d123dda 
Dealt to 65af0a69 
Dealt to Hero [Ks 6d Jc As]
Dealt to 5c0df65c 
65af0a69: raises $0.05 to $0.07
Hero: folds
5c0df65c: folds
185ba609: calls $0.07
1a8ba4a: folds
7d123dda: folds
*** FLOP *** [6h 3h Qs]
65af0a69: checks
185ba609: bets $0.16
65af0a69: calls $0.16
*** TURN *** [6h 3h Qs] [Ac]
65af0a69: checks
185ba609: checks
*** RIVER *** [6h 3h Qs Ac] [8c]
65af0a69: bets $0.49
185ba609: folds
Uncalled bet ($0.49) returned to 65af0a69
*** SHOWDOWN ***
65af0a69 collected $0.47 from pot
*** SUMMARY ***
Total pot $0.49 | Rake $0.02 | Jackpot $0 | Bingo $0
Board [6h 3h Qs Ac 8c]
Seat 1: 185ba609 (button) folded on the River
Seat 2: 1a8ba4a (small blind) folded before Flop
Seat 3: 7d123dda (big blind) folded before Flop
Seat 4: 65af0a69 won ($0.47)
Seat 5: Hero folded before Flop (didn't bet)
Seat 6: 5c0df65c folded before Flop (didn't bet)


Poker Hand #RC211925448: Omaha Pot Limit  ($0.01/$0.02) - 2022/10/21 12:34:51
Table 'RushAndCash1775448' 6-max Seat #1 is the button
Seat 1: 1eedbfa3 ($7.29 in chips)
Seat 2: ba900941 ($2.06 in chips)
Seat 3: 60c62cbf ($4.79 in chips)
Seat 4: bfe4eca ($2.78 in chips)
Seat 5: Hero ($1.19 in chips)
Seat 6: 2c413280 ($2.67 in chips)
ba900941: posts small blind $0.01
60c62cbf: posts big blind $0.02
*** HOLE CARDS ***
Dealt to 1eedbfa3 
Dealt to ba900941 
Dealt to 60c62cbf 
Dealt to bfe4eca 
Dealt to Hero [3d 2h Ah 8h]
Dealt to 2c413280 
bfe4eca: folds
Hero: folds
2c413280: folds
1eedbfa3: folds
ba900941: raises $0.02 to $0.04
60c62cbf: folds
Uncalled bet ($0.02) returned to ba900941
*** SHOWDOWN ***
ba900941 collected $0.04 from pot
*** SUMMARY ***
Total pot $0.04 | Rake $0 | Jackpot $0 | Bingo $0
Seat 1: 1eedbfa3 (button) folded before Flop (didn't bet)
Seat 2: ba900941 (small blind) collected ($0.04)
Seat 3: 60c62cbf (big blind) folded before Flop
Seat 4: bfe4eca folded before Flop (didn't bet)
Seat 5: Hero folded before Flop (didn't bet)
Seat 6: 2c413280 folded before Flop (didn't bet)


Poker Hand #RC211925441: Omaha Pot Limit  ($0.01/$0.02) - 2022/10/21 12:34:47
Table 'RushAndCash1775441' 6-max Seat #1 is the button
Seat 1: 360f356c ($3.9 in chips)
Seat 2: eb40d2f3 ($2.09 in chips)
Seat 3: Hero ($1.21 in chips)
Seat 4: 4530f74e ($2.89 in chips)
Seat 5: 612276db ($2 in chips)
Seat 6: d3e1cc8f ($2.16 in chips)
eb40d2f3: posts small blind $0.01
Hero: posts big blind $0.02
*** HOLE CARDS ***
Dealt to 360f356c 
Dealt to eb40d2f3 
Dealt to Hero [7s 5c 2s Jc]
Dealt to 4530f74e 
Dealt to 612276db 
Dealt to d3e1cc8f 
4530f74e: folds
612276db: folds
d3e1cc8f: raises $0.02 to $0.04
360f356c: folds
eb40d2f3: folds
Hero: folds
Uncalled bet ($0.02) returned to d3e1cc8f
*** SHOWDOWN ***
d3e1cc8f collected $0.05 from pot
*** SUMMARY ***
Total pot $0.05 | Rake $0 | Jackpot $0 | Bingo $0
Seat 1: 360f356c (button) folded before Flop (didn't bet)
Seat 2: eb40d2f3 (small blind) folded before Flop
Seat 3: Hero (big blind) folded before Flop
Seat 4: 4530f74e folded before Flop (didn't bet)
Seat 5: 612276db folded before Flop (didn't bet)
Seat 6: d3e1cc8f collected ($0.05)


Poker Hand #RC211925432: Omaha Pot Limit  ($0.01/$0.02) - 2022/10/21 12:34:43
Table 'RushAndCash1775432' 6-max Seat #1 is the button
Seat 1: eb40d2f3 ($2.09 in chips)
Seat 2: a1a9ea9c ($2.22 in chips)
Seat 3: 839711cf ($2.01 in chips)
Seat 4: 612276db ($2 in chips)
Seat 5: Hero ($1.21 in chips)
Seat 6: 61b92208 ($13.49 in chips)
a1a9ea9c: posts small blind $0.01
839711cf: posts big blind $0.02
*** HOLE CARDS ***
Dealt to eb40d2f3 
Dealt to a1a9ea9c 
Dealt to 839711cf 
Dealt to 612276db 
Dealt to Hero [7h 9d 8h 9c]
Dealt to 61b92208 
612276db: folds
Hero: folds
61b92208: folds
eb40d2f3: folds
a1a9ea9c: folds
Uncalled bet ($0.01) returned to 839711cf
*** SHOWDOWN ***
839711cf collected $0.02 from pot
*** SUMMARY ***
Total pot $0.02 | Rake $0 | Jackpot $0 | Bingo $0
Seat 1: eb40d2f3 (button) folded before Flop (didn't bet)
Seat 2: a1a9ea9c (small blind) folded before Flop
Seat 3: 839711cf (big blind) collected ($0.02)
Seat 4: 612276db folded before Flop (didn't bet)
Seat 5: Hero folded before Flop (didn't bet)
Seat 6: 61b92208 folded before Flop (didn't bet)


Poker Hand #RC211925425: Omaha Pot Limit  ($0.01/$0.02) - 2022/10/21 12:34:40
Table 'RushAndCash1775425' 6-max Seat #1 is the button
Seat 1: cd9739d7 ($2.01 in chips)
Seat 2: cdc6c025 ($3.15 in chips)
Seat 3: f5524b6e ($2 in chips)
Seat 4: Hero ($1.21 in chips)
Seat 5: c0930254 ($2 in chips)
Seat 6: 4beb7f7c ($2.94 in chips)
cdc6c025: posts small blind $0.01
f5524b6e: posts big blind $0.02
*** HOLE CARDS ***
Dealt to cd9739d7 
Dealt to cdc6c025 
Dealt to f5524b6e 
Dealt to Hero [Qs 8d Ah 5c]
Dealt to c0930254 
Dealt to 4beb7f7c 
Hero: folds
c0930254: folds
4beb7f7c: folds
cd9739d7: folds
cdc6c025: raises $0.02 to $0.04
f5524b6e: folds
Uncalled bet ($0.02) returned to cdc6c025
*** SHOWDOWN ***
cdc6c025 collected $0.04 from pot
*** SUMMARY ***
Total pot $0.04 | Rake $0 | Jackpot $0 | Bingo $0
Seat 1: cd9739d7 (button) folded before Flop (didn't bet)
Seat 2: cdc6c025 (small blind) collected ($0.04)
Seat 3: f5524b6e (big blind) folded before Flop
Seat 4: Hero folded before Flop (didn't bet)
Seat 5: c0930254 folded before Flop (didn't bet)
Seat 6: 4beb7f7c folded before Flop (didn't bet)


Poker Hand #RC211925416: Omaha Pot Limit  ($0.01/$0.02) - 2022/10/21 12:34:36
Table 'RushAndCash1775416' 6-max Seat #1 is the button
Seat 1: eae6d401 ($3.97 in chips)
Seat 2: Hero ($1.22 in chips)
Seat 3: 847618dc ($2.17 in chips)
Seat 4: 4530f74e ($2.89 in chips)
Seat 5: 3be5e736 ($2.15 in chips)
Seat 6: e294ba0b ($2.96 in chips)
Hero: posts small blind $0.01
847618dc: posts big blind $0.02
*** HOLE CARDS ***
Dealt to eae6d401 
Dealt to Hero [6c Qc 8h Jh]
Dealt to 847618dc 
Dealt to 4530f74e 
Dealt to 3be5e736 
Dealt to e294ba0b 
4530f74e: folds
3be5e736: folds
e294ba0b: folds
eae6d401: raises $0.05 to $0.07
Hero: folds
847618dc: folds
Uncalled bet ($0.05) returned to eae6d401
*** SHOWDOWN ***
eae6d401 collected $0.05 from pot
*** SUMMARY ***
Total pot $0.05 | Rake $0 | Jackpot $0 | Bingo $0
Seat 1: eae6d401 (button) collected ($0.05)
Seat 2: Hero (small blind) folded before Flop
Seat 3: 847618dc (big blind) folded before Flop
Seat 4: 4530f74e folded before Flop (didn't bet)
Seat 5: 3be5e736 folded before Flop (didn't bet)
Seat 6: e294ba0b folded before Flop (didn't bet)


Poker Hand #RC211925320: Omaha Pot Limit  ($0.01/$0.02) - 2022/10/21 12:33:49
Table 'RushAndCash1775320' 6-max Seat #1 is the button
Seat 1: Hero ($1.35 in chips)
Seat 2: 319523e5 ($2.06 in chips)
Seat 3: a6c42e85 ($1.86 in chips)
Seat 4: d6aeda0a ($0.84 in chips)
Seat 5: e294ba0b ($2.81 in chips)
Seat 6: f78e1a96 ($2.02 in chips)
319523e5: posts small blind $0.01
a6c42e85: posts big blind $0.02
*** HOLE CARDS ***
Dealt to Hero [5s 5c As Qd]
Dealt to 319523e5 
Dealt to a6c42e85 
Dealt to d6aeda0a 
Dealt to e294ba0b 
Dealt to f78e1a96 
d6aeda0a: folds
e294ba0b: raises $0.05 to $0.07
f78e1a96: folds
Hero: calls $0.07
319523e5: folds
a6c42e85: folds
*** FLOP *** [3s 3c 6d]
e294ba0b: checks
Hero: bets $0.06
e294ba0b: calls $0.06
*** TURN *** [3s 3c 6d] [7h]
e294ba0b: bets $0.15
Hero: folds
Uncalled bet ($0.15) returned to e294ba0b
*** SHOWDOWN ***
e294ba0b collected $0.28 from pot
*** SUMMARY ***
Total pot $0.29 | Rake $0.01 | Jackpot $0 | Bingo $0
Board [3s 3c 6d 7h]
Seat 1: Hero (button) folded on the Turn
Seat 2: 319523e5 (small blind) folded before Flop
Seat 3: a6c42e85 (big blind) folded before Flop
Seat 4: d6aeda0a folded before Flop (didn't bet)
Seat 5: e294ba0b won ($0.28)
Seat 6: f78e1a96 folded before Flop (didn't bet)


Poker Hand #RC211925305: Omaha Pot Limit  ($0.01/$0.02) - 2022/10/21 12:33:41
Table 'RushAndCash1775305' 6-max Seat #1 is the button
Seat 1: 2898300f ($5.91 in chips)
Seat 2: 16be129e ($3.16 in chips)
Seat 3: 582a77b7 ($6.72 in chips)
Seat 4: 6bebea35 ($2.14 in chips)
Seat 5: 1eedbfa3 ($7.39 in chips)
Seat 6: Hero ($1.35 in chips)
16be129e: posts small blind $0.01
582a77b7: posts big blind $0.02
*** HOLE CARDS ***
Dealt to 2898300f 
Dealt to 16be129e 
Dealt to 582a77b7 
Dealt to 6bebea35 
Dealt to 1eedbfa3 
Dealt to Hero [8s Qd Ad 6h]
6bebea35: folds
1eedbfa3: folds
Hero: folds
2898300f: folds
16be129e: folds
Uncalled bet ($0.01) returned to 582a77b7
*** SHOWDOWN ***
582a77b7 collected $0.02 from pot
*** SUMMARY ***
Total pot $0.02 | Rake $0 | Jackpot $0 | Bingo $0
Seat 1: 2898300f (button) folded before Flop (didn't bet)
Seat 2: 16be129e (small blind) folded before Flop
Seat 3: 582a77b7 (big blind) collected ($0.02)
Seat 4: 6bebea35 folded before Flop (didn't bet)
Seat 5: 1eedbfa3 folded before Flop (didn't bet)
Seat 6: Hero folded before Flop (didn't bet)


Poker Hand #RC211925297: Omaha Pot Limit  ($0.01/$0.02) - 2022/10/21 12:33:37
Table 'RushAndCash1775297' 6-max Seat #1 is the button
Seat 1: 223f5e09 ($2 in chips)
Seat 2: 7cc03d50 ($2 in chips)
Seat 3: 5332240a ($0.75 in chips)
Seat 4: c0930254 ($2 in chips)
Seat 5: Hero ($1.35 in chips)
Seat 6: bb360fb3 ($0.72 in chips)
7cc03d50: posts small blind $0.01
5332240a: posts big blind $0.02
*** HOLE CARDS ***
Dealt to 223f5e09 
Dealt to 7cc03d50 
Dealt to 5332240a 
Dealt to c0930254 
Dealt to Hero [7s 6h 5c 4d]
Dealt to bb360fb3 
c0930254: folds
Hero: folds
bb360fb3: calls $0.02
223f5e09: folds
7cc03d50: calls $0.01
5332240a: checks
*** FLOP *** [Ks 7d 5d]
7cc03d50: checks
5332240a: checks
bb360fb3: bets $0.06
7cc03d50: folds
5332240a: folds
Uncalled bet ($0.06) returned to bb360fb3
*** SHOWDOWN ***
bb360fb3 collected $0.06 from pot
*** SUMMARY ***
Total pot $0.06 | Rake $0 | Jackpot $0 | Bingo $0
Board [Ks 7d 5d]
Seat 1: 223f5e09 (button) folded before Flop (didn't bet)
Seat 2: 7cc03d50 (small blind) folded on the Flop
Seat 3: 5332240a (big blind) folded on the Flop
Seat 4: c0930254 folded before Flop (didn't bet)
Seat 5: Hero folded before Flop (didn't bet)
Seat 6: bb360fb3 won ($0.06)


Poker Hand #RC211925290: Omaha Pot Limit  ($0.01/$0.02) - 2022/10/21 12:33:33
Table 'RushAndCash1775290' 6-max Seat #1 is the button
Seat 1: bb360fb3 ($0.72 in chips)
Seat 2: f09190e1 ($2.07 in chips)
Seat 3: Hero ($1.37 in chips)
Seat 4: 847618dc ($2.2 in chips)
Seat 5: 6342f8d1 ($1.31 in chips)
Seat 6: 565b02dc ($2.9 in chips)
f09190e1: posts small blind $0.01
Hero: posts big blind $0.02
*** HOLE CARDS ***
Dealt to bb360fb3 
Dealt to f09190e1 
Dealt to Hero [Tc 3c 2d 5s]
Dealt to 847618dc 
Dealt to 6342f8d1 
Dealt to 565b02dc 
847618dc: folds
6342f8d1: folds
565b02dc: raises $0.05 to $0.07
bb360fb3: folds
f09190e1: folds
Hero: folds
Uncalled bet ($0.05) returned to 565b02dc
*** SHOWDOWN ***
565b02dc collected $0.05 from pot
*** SUMMARY ***
Total pot $0.05 | Rake $0 | Jackpot $0 | Bingo $0
Seat 1: bb360fb3 (button) folded before Flop (didn't bet)
Seat 2: f09190e1 (small blind) folded before Flop
Seat 3: Hero (big blind) folded before Flop
Seat 4: 847618dc folded before Flop (didn't bet)
Seat 5: 6342f8d1 folded before Flop (didn't bet)
Seat 6: 565b02dc collected ($0.05)


Poker Hand #RC211925283: Omaha Pot Limit  ($0.01/$0.02) - 2022/10/21 12:33:29
Table 'RushAndCash1775283' 6-max Seat #1 is the button
Seat 1: 233cbc40 ($1.88 in chips)
Seat 2: Hero ($1.38 in chips)
Seat 3: 1d7f4966 ($2.44 in chips)
Seat 4: 9fa75ace ($1.11 in chips)
Seat 5: 95a39865 ($8.82 in chips)
Seat 6: 5f9f0099 ($9.85 in chips)
Hero: posts small blind $0.01
1d7f4966: posts big blind $0.02
*** HOLE CARDS ***
Dealt to 233cbc40 
Dealt to Hero [2d 9d As 7s]
Dealt to 1d7f4966 
Dealt to 9fa75ace 
Dealt to 95a39865 
Dealt to 5f9f0099 
9fa75ace: folds
95a39865: raises $0.03 to $0.05
5f9f0099: folds
233cbc40: calls $0.05
Hero: folds
1d7f4966: folds
*** FLOP *** [5s 7c Ah]
95a39865: checks
233cbc40: checks
*** TURN *** [5s 7c Ah] [7d]
95a39865: checks
233cbc40: checks
*** RIVER *** [5s 7c Ah 7d] [5d]
95a39865: checks
233cbc40: checks
95a39865: shows [9s Jc Ks Td] (Pair of Sevens)
233cbc40: shows [Kc 9c Kd 8h] (Pair of Kings and Pair of Sevens)
*** SHOWDOWN ***
233cbc40 collected $0.13 from pot
*** SUMMARY ***
Total pot $0.13 | Rake $0 | Jackpot $0 | Bingo $0
Board [5s 7c Ah 7d 5d]
Seat 1: 233cbc40 (button) showed [Kc 9c Kd 8h] and won ($0.13) with Pair of Kings and Pair of Sevens
Seat 2: Hero (small blind) folded before Flop
Seat 3: 1d7f4966 (big blind) folded before Flop
Seat 4: 9fa75ace folded before Flop (didn't bet)
Seat 5: 95a39865 showed [9s Jc Ks Td] and lost with Pair of Sevens
Seat 6: 5f9f0099 folded before Flop (didn't bet)


Poker Hand #RC211925275: Omaha Pot Limit  ($0.01/$0.02) - 2022/10/21 12:33:25
Table 'RushAndCash1775275' 6-max Seat #1 is the button
Seat 1: Hero ($1.38 in chips)
Seat 2: a6c42e85 ($1.87 in chips)
Seat 3: 55386e9f ($2 in chips)
Seat 4: 65893a3a ($2.02 in chips)
Seat 5: 46b42320 ($1.09 in chips)
Seat 6: ad0bd7ed ($2.38 in chips)
a6c42e85: posts small blind $0.01
55386e9f: posts big blind $0.02
*** HOLE CARDS ***
Dealt to Hero [6d Qc 4h 8d]
Dealt to a6c42e85 
Dealt to 55386e9f 
Dealt to 65893a3a 
Dealt to 46b42320 
Dealt to ad0bd7ed 
65893a3a: folds
46b42320: folds
ad0bd7ed: raises $0.05 to $0.07
Hero: folds
a6c42e85: folds
55386e9f: folds
Uncalled bet ($0.05) returned to ad0bd7ed
*** SHOWDOWN ***
ad0bd7ed collected $0.05 from pot
*** SUMMARY ***
Total pot $0.05 | Rake $0 | Jackpot $0 | Bingo $0
Seat 1: Hero (button) folded before Flop (didn't bet)
Seat 2: a6c42e85 (small blind) folded before Flop
Seat 3: 55386e9f (big blind) folded before Flop
Seat 4: 65893a3a folded before Flop (didn't bet)
Seat 5: 46b42320 folded before Flop (didn't bet)
Seat 6: ad0bd7ed collected ($0.05)


Poker Hand #RC211925266: Omaha Pot Limit  ($0.01/$0.02) - 2022/10/21 12:33:21
Table 'RushAndCash1775266' 6-max Seat #1 is the button
Seat 1: 52f04e3d ($2.38 in chips)
Seat 2: 5f9f0099 ($9.86 in chips)
Seat 3: 4eefd3b ($2.63 in chips)
Seat 4: 6d9970e3 ($1.71 in chips)
Seat 5: fee0e58a ($2.1 in chips)
Seat 6: Hero ($1.38 in chips)
5f9f0099: posts small blind $0.01
4eefd3b: posts big blind $0.02
*** HOLE CARDS ***
Dealt to 52f04e3d 
Dealt to 5f9f0099 
Dealt to 4eefd3b 
Dealt to 6d9970e3 
Dealt to fee0e58a 
Dealt to Hero [Kc Jd Tc 6h]
6d9970e3: folds
fee0e58a: folds
Hero: folds
52f04e3d: raises $0.05 to $0.07
5f9f0099: folds
4eefd3b: calls $0.05
*** FLOP *** [Td Jh 3s]
4eefd3b: checks
52f04e3d: bets $0.08
4eefd3b: calls $0.08
*** TURN *** [Td Jh 3s] [Jc]
4eefd3b: checks
52f04e3d: bets $0.14
4eefd3b: folds
Uncalled bet ($0.14) returned to 52f04e3d
*** SHOWDOWN ***
52f04e3d collected $0.3 from pot
*** SUMMARY ***
Total pot $0.31 | Rake $0.01 | Jackpot $0 | Bingo $0
Board [Td Jh 3s Jc]
Seat 1: 52f04e3d (button) won ($0.3)
Seat 2: 5f9f0099 (small blind) folded before Flop
Seat 3: 4eefd3b (big blind) folded on the Turn
Seat 4: 6d9970e3 folded before Flop (didn't bet)
Seat 5: fee0e58a folded before Flop (didn't bet)
Seat 6: Hero folded before Flop (didn't bet)


Poker Hand #RC211925259: Omaha Pot Limit  ($0.01/$0.02) - 2022/10/21 12:33:18
Table 'RushAndCash1775259' 6-max Seat #1 is the button
Seat 1: cdc6c025 ($3.08 in chips)
Seat 2: 5332240a ($0.73 in chips)
Seat 3: 128e0aac ($4.56 in chips)
Seat 4: 6a90d83f ($2 in chips)
Seat 5: Hero ($1.38 in chips)
Seat 6: 4f245f58 ($2.4 in chips)
5332240a: posts small blind $0.01
128e0aac: posts big blind $0.02
*** HOLE CARDS ***
Dealt to cdc6c025 
Dealt to 5332240a 
Dealt to 128e0aac 
Dealt to 6a90d83f 
Dealt to Hero [7s 5s Tc 8h]
Dealt to 4f245f58 
6a90d83f: folds
Hero: folds
4f245f58: folds
cdc6c025: folds
5332240a: raises $0.04 to $0.06
128e0aac: folds
Uncalled bet ($0.04) returned to 5332240a
*** SHOWDOWN ***
5332240a collected $0.04 from pot
*** SUMMARY ***
Total pot $0.04 | Rake $0 | Jackpot $0 | Bingo $0
Seat 1: cdc6c025 (button) folded before Flop (didn't bet)
Seat 2: 5332240a (small blind) collected ($0.04)
Seat 3: 128e0aac (big blind) folded before Flop
Seat 4: 6a90d83f folded before Flop (didn't bet)
Seat 5: Hero folded before Flop (didn't bet)
Seat 6: 4f245f58 folded before Flop (didn't bet)


Poker Hand #RC211925251: Omaha Pot Limit  ($0.01/$0.02) - 2022/10/21 12:33:15
Table 'RushAndCash1775251' 6-max Seat #1 is the button
Seat 1: 599a53ee ($5.32 in chips)
Seat 2: 1eedbfa3 ($7.41 in chips)
Seat 3: eb40d2f3 ($2.22 in chips)
Seat 4: 6b74825b ($2 in chips)
Seat 5: c9b9e9c8 ($2 in chips)
Seat 6: Hero ($1.38 in chips)
1eedbfa3: posts small blind $0.01
eb40d2f3: posts big blind $0.02
*** HOLE CARDS ***
Dealt to 599a53ee 
Dealt to 1eedbfa3 
Dealt to eb40d2f3 
Dealt to 6b74825b 
Dealt to c9b9e9c8 
Dealt to Hero [2d 8s 6s 6d]
6b74825b: folds
c9b9e9c8: folds
Hero: folds
599a53ee: raises $0.05 to $0.07
1eedbfa3: folds
eb40d2f3: calls $0.05
*** FLOP *** [Ts 3s 9d]
eb40d2f3: checks
599a53ee: checks
*** TURN *** [Ts 3s 9d] [2h]
eb40d2f3: checks
599a53ee: checks
*** RIVER *** [Ts 3s 9d 2h] [4s]
eb40d2f3: checks
599a53ee: checks
eb40d2f3: shows [8c 4d Qd 6c] (Pair of Fours)
599a53ee: shows [3h Kc Kd Jc] (Pair of Kings)
*** SHOWDOWN ***
599a53ee collected $0.15 from pot
*** SUMMARY ***
Total pot $0.15 | Rake $0 | Jackpot $0 | Bingo $0
Board [Ts 3s 9d 2h 4s]
Seat 1: 599a53ee (button) showed [3h Kc Kd Jc] and won ($0.15) with Pair of Kings
Seat 2: 1eedbfa3 (small blind) folded before Flop
Seat 3: eb40d2f3 (big blind) showed [8c 4d Qd 6c] and lost with Pair of Fours
Seat 4: 6b74825b folded before Flop (didn't bet)
Seat 5: c9b9e9c8 folded before Flop (didn't bet)
Seat 6: Hero folded before Flop (didn't bet)


Poker Hand #RC211925234: Omaha Pot Limit  ($0.01/$0.02) - 2022/10/21 12:33:06
Table 'RushAndCash1775234' 6-max Seat #1 is the button
Seat 1: 847618dc ($2.17 in chips)
Seat 2: Hero ($1.39 in chips)
Seat 3: cfbaf2a9 ($6.26 in chips)
Seat 4: 1eedbfa3 ($7.41 in chips)
Seat 5: bfe4eca ($2.84 in chips)
Seat 6: c0930254 ($2 in chips)
Hero: posts small blind $0.01
cfbaf2a9: posts big blind $0.02
*** HOLE CARDS ***
Dealt to 847618dc 
Dealt to Hero [6d Qh 5h Jd]
Dealt to cfbaf2a9 
Dealt to 1eedbfa3 
Dealt to bfe4eca 
Dealt to c0930254 
1eedbfa3: folds
bfe4eca: folds
c0930254: folds
847618dc: raises $0.05 to $0.07
Hero: folds
cfbaf2a9: folds
Uncalled bet ($0.05) returned to 847618dc
*** SHOWDOWN ***
847618dc collected $0.05 from pot
*** SUMMARY ***
Total pot $0.05 | Rake $0 | Jackpot $0 | Bingo $0
Seat 1: 847618dc (button) collected ($0.05)
Seat 2: Hero (small blind) folded before Flop
Seat 3: cfbaf2a9 (big blind) folded before Flop
Seat 4: 1eedbfa3 folded before Flop (didn't bet)
Seat 5: bfe4eca folded before Flop (didn't bet)
Seat 6: c0930254 folded before Flop (didn't bet)


Poker Hand #RC211925224: Omaha Pot Limit  ($0.01/$0.02) - 2022/10/21 12:33:02
Table 'RushAndCash1775224' 6-max Seat #1 is the button
Seat 1: 47700101 ($2.7 in chips)
Seat 2: 4beb7f7c ($3.21 in chips)
Seat 3: Hero ($1.41 in chips)
Seat 4: 7cf97e5c ($2.03 in chips)
Seat 5: 73e9cdad ($3.21 in chips)
Seat 6: f2309695 ($2.76 in chips)
4beb7f7c: posts small blind $0.01
Hero: posts big blind $0.02
*** HOLE CARDS ***
Dealt to 47700101 
Dealt to 4beb7f7c 
Dealt to Hero [As 2c Qs 4h]
Dealt to 7cf97e5c 
Dealt to 73e9cdad 
Dealt to f2309695 
7cf97e5c: folds
73e9cdad: folds
f2309695: folds
47700101: raises $0.02 to $0.04
4beb7f7c: calls $0.03
Hero: folds
*** FLOP *** [5c 5h Jc]
4beb7f7c: checks
47700101: checks
*** TURN *** [5c 5h Jc] [4d]
4beb7f7c: checks
47700101: checks
*** RIVER *** [5c 5h Jc 4d] [8d]
4beb7f7c: checks
47700101: checks
4beb7f7c: shows [Qh 8c Ah 4c] (Pair of Eights and Pair of Fives)
47700101: shows [9s 7h Ts Jd] (Pair of Jacks and Pair of Fives)
*** SHOWDOWN ***
47700101 collected $0.1 from pot
*** SUMMARY ***
Total pot $0.1 | Rake $0 | Jackpot $0 | Bingo $0
Board [5c 5h Jc 4d 8d]
Seat 1: 47700101 (button) showed [9s 7h Ts Jd] and won ($0.1) with Pair of Jacks and Pair of Fives
Seat 2: 4beb7f7c (small blind) showed [Qh 8c Ah 4c] and lost with Pair of Eights and Pair of Fives
Seat 3: Hero (big blind) folded before Flop
Seat 4: 7cf97e5c folded before Flop (didn't bet)
Seat 5: 73e9cdad folded before Flop (didn't bet)
Seat 6: f2309695 folded before Flop (didn't bet)


Poker Hand #RC211925216: Omaha Pot Limit  ($0.01/$0.02) - 2022/10/21 12:32:58
Table 'RushAndCash1775216' 6-max Seat #1 is the button
Seat 1: Hero ($1.41 in chips)
Seat 2: f41cec53 ($3.25 in chips)
Seat 3: a4e6fc19 ($2.27 in chips)
Seat 4: 51d17ee8 ($1.62 in chips)
Seat 5: 5e85d999 ($4.12 in chips)
Seat 6: f2309695 ($2.76 in chips)
f41cec53: posts small blind $0.01
a4e6fc19: posts big blind $0.02
*** HOLE CARDS ***
Dealt to Hero [6h 4h 8s Qs]
Dealt to f41cec53 
Dealt to a4e6fc19 
Dealt to 51d17ee8 
Dealt to 5e85d999 
Dealt to f2309695 
51d17ee8: folds
5e85d999: raises $0.02 to $0.04
f2309695: folds
Hero: folds
f41cec53: calls $0.03
a4e6fc19: calls $0.02
*** FLOP *** [7d 4c 3d]
f41cec53: checks
a4e6fc19: checks
5e85d999: bets $0.02
f41cec53: calls $0.02
a4e6fc19: calls $0.02
*** TURN *** [7d 4c 3d] [2d]
f41cec53: checks
a4e6fc19: checks
5e85d999: bets $0.02
f41cec53: calls $0.02
a4e6fc19: calls $0.02
*** RIVER *** [7d 4c 3d 2d] [5s]
f41cec53: checks
a4e6fc19: checks
5e85d999: bets $0.02
f41cec53: calls $0.02
a4e6fc19: calls $0.02
5e85d999: shows [3h Kh Kd Td] (King High Flush)
f41cec53: shows [2c Kc Ah 2h] (Fives-High Straight)
a4e6fc19: shows [As Ad Tc 5h] (Fives-High Straight)
*** SHOWDOWN ***
5e85d999 collected $0.29 from pot
*** SUMMARY ***
Total pot $0.3 | Rake $0.01 | Jackpot $0 | Bingo $0
Board [7d 4c 3d 2d 5s]
Seat 1: Hero (button) folded before Flop (didn't bet)
Seat 2: f41cec53 (small blind) showed [2c Kc Ah 2h] and lost with Fives-High Straight
Seat 3: a4e6fc19 (big blind) showed [As Ad Tc 5h] and lost with Fives-High Straight
Seat 4: 51d17ee8 folded before Flop (didn't bet)
Seat 5: 5e85d999 showed [3h Kh Kd Td] and won ($0.29) with King High Flush
Seat 6: f2309695 folded before Flop (didn't bet)


Poker Hand #RC211925204: Omaha Pot Limit  ($0.01/$0.02) - 2022/10/21 12:32:54
Table 'RushAndCash1775204' 6-max Seat #1 is the button
Seat 1: 6ef50542 ($4.44 in chips)
Seat 2: 201d8c95 ($2.15 in chips)
Seat 3: a2ca86df ($2 in chips)
Seat 4: 159180db ($5.42 in chips)
Seat 5: a30ea4fe ($2.12 in chips)
Seat 6: Hero ($1.41 in chips)
201d8c95: posts small blind $0.01
a2ca86df: posts big blind $0.02
*** HOLE CARDS ***
Dealt to 6ef50542 
Dealt to 201d8c95 
Dealt to a2ca86df 
Dealt to 159180db 
Dealt to a30ea4fe 
Dealt to Hero [8d 9s 9h 7c]
159180db: folds
a30ea4fe: folds
Hero: folds
6ef50542: raises $0.03 to $0.05
201d8c95: raises $0.12 to $0.17
a2ca86df: folds
6ef50542: calls $0.12
*** FLOP *** [Ts 3d 5h]
201d8c95: bets $0.27
6ef50542: folds
Uncalled bet ($0.27) returned to 201d8c95
*** SHOWDOWN ***
201d8c95 collected $0.35 from pot
*** SUMMARY ***
Total pot $0.36 | Rake $0.01 | Jackpot $0 | Bingo $0
Board [Ts 3d 5h]
Seat 1: 6ef50542 (button) folded on the Flop
Seat 2: 201d8c95 (small blind) won ($0.35)
Seat 3: a2ca86df (big blind) folded before Flop
Seat 4: 159180db folded before Flop (didn't bet)
Seat 5: a30ea4fe folded before Flop (didn't bet)
Seat 6: Hero folded before Flop (didn't bet)


Poker Hand #RC211925190: Omaha Pot Limit  ($0.01/$0.02) - 2022/10/21 12:32:49
Table 'RushAndCash1775190' 6-max Seat #1 is the button
Seat 1: 4e8b52d ($2 in chips)
Seat 2: c7c1cd57 ($2 in chips)
Seat 3: 17c11c29 ($2.52 in chips)
Seat 4: 1eedbfa3 ($7.44 in chips)
Seat 5: Hero ($1.41 in chips)
Seat 6: 839711cf ($1.93 in chips)
c7c1cd57: posts small blind $0.01
17c11c29: posts big blind $0.02
*** HOLE CARDS ***
Dealt to 4e8b52d 
Dealt to c7c1cd57 
Dealt to 17c11c29 
Dealt to 1eedbfa3 
Dealt to Hero [Ah 7c 3c Ac]
Dealt to 839711cf 
1eedbfa3: folds
Hero: folds
839711cf: folds
4e8b52d: folds
c7c1cd57: folds
Uncalled bet ($0.01) returned to 17c11c29
*** SHOWDOWN ***
17c11c29 collected $0.02 from pot
*** SUMMARY ***
Total pot $0.02 | Rake $0 | Jackpot $0 | Bingo $0
Seat 1: 4e8b52d (button) folded before Flop (didn't bet)
Seat 2: c7c1cd57 (small blind) folded before Flop
Seat 3: 17c11c29 (big blind) collected ($0.02)
Seat 4: 1eedbfa3 folded before Flop (didn't bet)
Seat 5: Hero folded before Flop (didn't bet)
Seat 6: 839711cf folded before Flop (didn't bet)


Poker Hand #RC211925179: Omaha Pot Limit  ($0.01/$0.02) - 2022/10/21 12:32:43
Table 'RushAndCash1775179' 6-max Seat #1 is the button
Seat 1: 28ae6ae1 ($2.57 in chips)
Seat 2: 877e01b8 ($0.4 in chips)
Seat 3: eb8e436f ($1.79 in chips)
Seat 4: Hero ($1.41 in chips)
Seat 5: b8bdc23f ($4.52 in chips)
Seat 6: efa6db66 ($2.31 in chips)
877e01b8: posts small blind $0.01
eb8e436f: posts big blind $0.02
*** HOLE CARDS ***
Dealt to 28ae6ae1 
Dealt to 877e01b8 
Dealt to eb8e436f 
Dealt to Hero [Jc Kh Tc 9h]
Dealt to b8bdc23f 
Dealt to efa6db66 
Hero: folds
b8bdc23f: folds
efa6db66: folds
28ae6ae1: folds
877e01b8: folds
Uncalled bet ($0.01) returned to eb8e436f
*** SHOWDOWN ***
eb8e436f collected $0.02 from pot
*** SUMMARY ***
Total pot $0.02 | Rake $0 | Jackpot $0 | Bingo $0
Seat 1: 28ae6ae1 (button) folded before Flop (didn't bet)
Seat 2: 877e01b8 (small blind) folded before Flop
Seat 3: eb8e436f (big blind) collected ($0.02)
Seat 4: Hero folded before Flop (didn't bet)
Seat 5: b8bdc23f folded before Flop (didn't bet)
Seat 6: efa6db66 folded before Flop (didn't bet)


Poker Hand #RC211925170: Omaha Pot Limit  ($0.01/$0.02) - 2022/10/21 12:32:40
Table 'RushAndCash1775170' 6-max Seat #1 is the button
Seat 1: ffe38b0e ($1.95 in chips)
Seat 2: aa989090 ($2.04 in chips)
Seat 3: Hero ($1.43 in chips)
Seat 4: caac9df ($2.97 in chips)
Seat 5: 1cecdaa3 ($3.54 in chips)
Seat 6: ae7180e7 ($2 in chips)
aa989090: posts small blind $0.01
Hero: posts big blind $0.02
*** HOLE CARDS ***
Dealt to ffe38b0e 
Dealt to aa989090 
Dealt to Hero [2c 9h Kc 9d]
Dealt to caac9df 
Dealt to 1cecdaa3 
Dealt to ae7180e7 
caac9df: folds
1cecdaa3: folds
ae7180e7: folds
ffe38b0e: raises $0.04 to $0.06
aa989090: folds
Hero: folds
Uncalled bet ($0.04) returned to ffe38b0e
*** SHOWDOWN ***
ffe38b0e collected $0.05 from pot
*** SUMMARY ***
Total pot $0.05 | Rake $0 | Jackpot $0 | Bingo $0
Seat 1: ffe38b0e (button) collected ($0.05)
Seat 2: aa989090 (small blind) folded before Flop
Seat 3: Hero (big blind) folded before Flop
Seat 4: caac9df folded before Flop (didn't bet)
Seat 5: 1cecdaa3 folded before Flop (didn't bet)
Seat 6: ae7180e7 folded before Flop (didn't bet)


Poker Hand #RC211923444: Omaha Pot Limit  ($0.01/$0.02) - 2022/10/21 12:19:01
Table 'RushAndCash1773444' 6-max Seat #1 is the button
Seat 1: Hero ($1.43 in chips)
Seat 2: 47700101 ($2.02 in chips)
Seat 3: a785905a ($2.68 in chips)
Seat 4: e03ced8b ($0.74 in chips)
Seat 5: 233cbc40 ($2.31 in chips)
Seat 6: d1a86b34 ($2.26 in chips)
47700101: posts small blind $0.01
a785905a: posts big blind $0.02
*** HOLE CARDS ***
Dealt to Hero [8s 2c Ks Th]
Dealt to 47700101 
Dealt to a785905a 
Dealt to e03ced8b 
Dealt to 233cbc40 
Dealt to d1a86b34 
e03ced8b: folds
233cbc40: folds
d1a86b34: folds
Hero: folds
47700101: folds
Uncalled bet ($0.01) returned to a785905a
*** SHOWDOWN ***
a785905a collected $0.02 from pot
*** SUMMARY ***
Total pot $0.02 | Rake $0 | Jackpot $0 | Bingo $0
Seat 1: Hero (button) folded before Flop (didn't bet)
Seat 2: 47700101 (small blind) folded before Flop
Seat 3: a785905a (big blind) collected ($0.02)
Seat 4: e03ced8b folded before Flop (didn't bet)
Seat 5: 233cbc40 folded before Flop (didn't bet)
Seat 6: d1a86b34 folded before Flop (didn't bet)


Poker Hand #RC211923399: Omaha Pot Limit  ($0.01/$0.02) - 2022/10/21 12:18:39
Table 'RushAndCash1773399' 6-max Seat #1 is the button
Seat 1: 17eabed ($2.83 in chips)
Seat 2: Hero ($1.5 in chips)
Seat 3: f229addc ($5.98 in chips)
Seat 4: b065516c ($2.41 in chips)
Seat 5: 233cbc40 ($2.22 in chips)
Seat 6: 1d97e8a9 ($2 in chips)
Hero: posts small blind $0.01
f229addc: posts big blind $0.02
*** HOLE CARDS ***
Dealt to 17eabed 
Dealt to Hero [As 8c Ah 4h]
Dealt to f229addc 
Dealt to b065516c 
Dealt to 233cbc40 
Dealt to 1d97e8a9 
b065516c: folds
233cbc40: raises $0.05 to $0.07
1d97e8a9: folds
17eabed: folds
Hero: calls $0.06
f229addc: folds
*** FLOP *** [9d 8d Ks]
Hero: checks
233cbc40: bets $0.12
Hero: folds
Uncalled bet ($0.12) returned to 233cbc40
*** SHOWDOWN ***
233cbc40 collected $0.16 from pot
*** SUMMARY ***
Total pot $0.16 | Rake $0 | Jackpot $0 | Bingo $0
Board [9d 8d Ks]
Seat 1: 17eabed (button) folded before Flop (didn't bet)
Seat 2: Hero (small blind) folded on the Flop
Seat 3: f229addc (big blind) folded before Flop
Seat 4: b065516c folded before Flop (didn't bet)
Seat 5: 233cbc40 won ($0.16)
Seat 6: 1d97e8a9 folded before Flop (didn't bet)


Poker Hand #RC211923392: Omaha Pot Limit  ($0.01/$0.02) - 2022/10/21 12:18:35
Table 'RushAndCash1773392' 6-max Seat #1 is the button
Seat 1: 17eabed ($2.83 in chips)
Seat 2: d4099468 ($2.22 in chips)
Seat 3: bb526376 ($2 in chips)
Seat 4: caac9df ($3.75 in chips)
Seat 5: 5c4faaca ($2.4 in chips)
Seat 6: Hero ($1.5 in chips)
d4099468: posts small blind $0.01
bb526376: posts big blind $0.02
*** HOLE CARDS ***
Dealt to 17eabed 
Dealt to d4099468 
Dealt to bb526376 
Dealt to caac9df 
Dealt to 5c4faaca 
Dealt to Hero [8s 2s Qd 5c]
caac9df: folds
5c4faaca: folds
Hero: folds
17eabed: folds
d4099468: calls $0.01
bb526376: raises $0.04 to $0.06
d4099468: folds
Uncalled bet ($0.04) returned to bb526376
*** SHOWDOWN ***
bb526376 collected $0.04 from pot
*** SUMMARY ***
Total pot $0.04 | Rake $0 | Jackpot $0 | Bingo $0
Seat 1: 17eabed (button) folded before Flop (didn't bet)
Seat 2: d4099468 (small blind) folded before Flop
Seat 3: bb526376 (big blind) collected ($0.04)
Seat 4: caac9df folded before Flop (didn't bet)
Seat 5: 5c4faaca folded before Flop (didn't bet)
Seat 6: Hero folded before Flop (didn't bet)


Poker Hand #RC211923384: Omaha Pot Limit  ($0.01/$0.02) - 2022/10/21 12:18:32
Table 'RushAndCash1773384' 6-max Seat #1 is the button
Seat 1: 88fd0c1c ($5.98 in chips)
Seat 2: 3d6a315d ($0.19 in chips)
Seat 3: cdea6e5b ($6.57 in chips)
Seat 4: 5c4faaca ($2.4 in chips)
Seat 5: Hero ($1.5 in chips)
Seat 6: 2770488c ($2.09 in chips)
3d6a315d: posts small blind $0.01
cdea6e5b: posts big blind $0.02
*** HOLE CARDS ***
Dealt to 88fd0c1c 
Dealt to 3d6a315d 
Dealt to cdea6e5b 
Dealt to 5c4faaca 
Dealt to Hero [8d Td Kh 2c]
Dealt to 2770488c 
5c4faaca: folds
Hero: folds
2770488c: folds
88fd0c1c: folds
3d6a315d: folds
Uncalled bet ($0.01) returned to cdea6e5b
*** SHOWDOWN ***
cdea6e5b collected $0.02 from pot
*** SUMMARY ***
Total pot $0.02 | Rake $0 | Jackpot $0 | Bingo $0
Seat 1: 88fd0c1c (button) folded before Flop (didn't bet)
Seat 2: 3d6a315d (small blind) folded before Flop
Seat 3: cdea6e5b (big blind) collected ($0.02)
Seat 4: 5c4faaca folded before Flop (didn't bet)
Seat 5: Hero folded before Flop (didn't bet)
Seat 6: 2770488c folded before Flop (didn't bet)


Poker Hand #RC211922939: Omaha Pot Limit  ($0.01/$0.02) - 2022/10/21 12:14:28
Table 'RushAndCash1772939' 6-max Seat #1 is the button
Seat 1: 75dac434 ($2.31 in chips)
Seat 2: 2797f0a1 ($0.38 in chips)
Seat 3: 6f5c969f ($1.13 in chips)
Seat 4: 792e227 ($11.5 in chips)
Seat 5: Hero ($1.5 in chips)
Seat 6: 231cc405 ($2 in chips)
2797f0a1: posts small blind $0.01
6f5c969f: posts big blind $0.02
*** HOLE CARDS ***
Dealt to 75dac434 
Dealt to 2797f0a1 
Dealt to 6f5c969f 
Dealt to 792e227 
Dealt to Hero [9c Qc Ks 2d]
Dealt to 231cc405 
792e227: raises $0.05 to $0.07
Hero: folds
231cc405: folds
75dac434: folds
2797f0a1: folds
6f5c969f: calls $0.05
*** FLOP *** [6c 2c Kd]
6f5c969f: checks
792e227: checks
*** TURN *** [6c 2c Kd] [2s]
6f5c969f: checks
792e227: bets $0.09
6f5c969f: folds
Uncalled bet ($0.09) returned to 792e227
*** SHOWDOWN ***
792e227 collected $0.15 from pot
*** SUMMARY ***
Total pot $0.15 | Rake $0 | Jackpot $0 | Bingo $0
Board [6c 2c Kd 2s]
Seat 1: 75dac434 (button) folded before Flop (didn't bet)
Seat 2: 2797f0a1 (small blind) folded before Flop
Seat 3: 6f5c969f (big blind) folded on the Turn
Seat 4: 792e227 won ($0.15)
Seat 5: Hero folded before Flop (didn't bet)
Seat 6: 231cc405 folded before Flop (didn't bet)


Poker Hand #RC211922877: Omaha Pot Limit  ($0.01/$0.02) - 2022/10/21 12:13:55
Table 'RushAndCash1772877' 6-max Seat #1 is the button
Seat 1: Hero ($1.57 in chips)
Seat 2: 64196626 ($2.67 in chips)
Seat 3: c3e9555e ($2.05 in chips)
Seat 4: f7da64ab ($2.12 in chips)
Seat 5: 6bebea35 ($2 in chips)
Seat 6: d85c7b89 ($2.12 in chips)
64196626: posts small blind $0.01
c3e9555e: posts big blind $0.02
*** HOLE CARDS ***
Dealt to Hero [Kd Tc Ks 2h]
Dealt to 64196626 
Dealt to c3e9555e 
Dealt to f7da64ab 
Dealt to 6bebea35 
Dealt to d85c7b89 
f7da64ab: folds
6bebea35: raises $0.05 to $0.07
d85c7b89: calls $0.07
Hero: calls $0.07
64196626: calls $0.06
c3e9555e: folds
*** FLOP *** [2c Ad 4c]
64196626: checks
6bebea35: bets $0.21
d85c7b89: calls $0.21
Hero: folds
64196626: folds
*** TURN *** [2c Ad 4c] [Qc]
6bebea35: bets $0.49
d85c7b89: folds
Uncalled bet ($0.49) returned to 6bebea35
*** SHOWDOWN ***
6bebea35 collected $0.66 from pot
*** SUMMARY ***
Total pot $0.72 | Rake $0.03 | Jackpot $0.03 | Bingo $0
Board [2c Ad 4c Qc]
Seat 1: Hero (button) folded on the Flop
Seat 2: 64196626 (small blind) folded on the Flop
Seat 3: c3e9555e (big blind) folded before Flop
Seat 4: f7da64ab folded before Flop (didn't bet)
Seat 5: 6bebea35 won ($0.66)
Seat 6: d85c7b89 folded on the Turn


Poker Hand #RC211922871: Omaha Pot Limit  ($0.01/$0.02) - 2022/10/21 12:13:51
Table 'RushAndCash1772871' 6-max Seat #1 is the button
Seat 1: 38ddecaa ($0.78 in chips)
Seat 2: Hero ($1.58 in chips)
Seat 3: 7cc03d50 ($2.11 in chips)
Seat 4: ad0bd7ed ($3.95 in chips)
Seat 5: 233cbc40 ($2 in chips)
Seat 6: 4eefd3b ($3.48 in chips)
Hero: posts small blind $0.01
7cc03d50: posts big blind $0.02
*** HOLE CARDS ***
Dealt to 38ddecaa 
Dealt to Hero [5c Qs 7s 4s]
Dealt to 7cc03d50 
Dealt to ad0bd7ed 
Dealt to 233cbc40 
Dealt to 4eefd3b 
ad0bd7ed: folds
233cbc40: folds
4eefd3b: raises $0.05 to $0.07
38ddecaa: calls $0.07
Hero: folds
7cc03d50: folds
*** FLOP *** [Qh 4h 4d]
4eefd3b: bets $0.06
38ddecaa: calls $0.06
*** TURN *** [Qh 4h 4d] [Qd]
4eefd3b: bets $0.1
38ddecaa: calls $0.1
*** RIVER *** [Qh 4h 4d Qd] [6c]
4eefd3b: bets $0.17
38ddecaa: folds
Uncalled bet ($0.17) returned to 4eefd3b
*** SHOWDOWN ***
4eefd3b collected $0.47 from pot
*** SUMMARY ***
Total pot $0.49 | Rake $0.02 | Jackpot $0 | Bingo $0
Board [Qh 4h 4d Qd 6c]
Seat 1: 38ddecaa (button) folded on the River
Seat 2: Hero (small blind) folded before Flop
Seat 3: 7cc03d50 (big blind) folded before Flop
Seat 4: ad0bd7ed folded before Flop (didn't bet)
Seat 5: 233cbc40 folded before Flop (didn't bet)
Seat 6: 4eefd3b won ($0.47)


Poker Hand #RC211922823: Omaha Pot Limit  ($0.01/$0.02) - 2022/10/21 12:13:23
Table 'RushAndCash1772823' 6-max Seat #1 is the button
Seat 1: 5ae004e4 ($0.86 in chips)
Seat 2: 38ddecaa ($0.82 in chips)
Seat 3: Hero ($1.54 in chips)
Seat 4: 792e227 ($11.46 in chips)
Seat 5: 5537777d ($4.14 in chips)
Seat 6: f760f34f ($2 in chips)
38ddecaa: posts small blind $0.01
Hero: posts big blind $0.02
*** HOLE CARDS ***
Dealt to 5ae004e4 
Dealt to 38ddecaa 
Dealt to Hero [Kc 9s Ah 8s]
Dealt to 792e227 
Dealt to 5537777d 
Dealt to f760f34f 
792e227: folds
5537777d: folds
f760f34f: folds
5ae004e4: folds
38ddecaa: raises $0.02 to $0.04
Hero: raises $0.08 to $0.12
38ddecaa: folds
Uncalled bet ($0.08) returned to Hero
*** SHOWDOWN ***
Hero collected $0.08 from pot
*** SUMMARY ***
Total pot $0.08 | Rake $0 | Jackpot $0 | Bingo $0
Seat 1: 5ae004e4 (button) folded before Flop (didn't bet)
Seat 2: 38ddecaa (small blind) folded before Flop
Seat 3: Hero (big blind) collected ($0.08)
Seat 4: 792e227 folded before Flop (didn't bet)
Seat 5: 5537777d folded before Flop (didn't bet)
Seat 6: f760f34f folded before Flop (didn't bet)


Poker Hand #RC211922816: Omaha Pot Limit  ($0.01/$0.02) - 2022/10/21 12:13:20
Table 'RushAndCash1772816' 6-max Seat #1 is the button
Seat 1: aa989090 ($1.97 in chips)
Seat 2: 88fd0c1c ($5.96 in chips)
Seat 3: 193c2885 ($5.88 in chips)
Seat 4: 223047eb ($2.03 in chips)
Seat 5: 792e227 ($11.46 in chips)
Seat 6: Hero ($1.54 in chips)
88fd0c1c: posts small blind $0.01
193c2885: posts big blind $0.02
*** HOLE CARDS ***
Dealt to aa989090 
Dealt to 88fd0c1c 
Dealt to 193c2885 
Dealt to 223047eb 
Dealt to 792e227 
Dealt to Hero [9s 8s 2s 8h]
223047eb: folds
792e227: folds
Hero: folds
aa989090: folds
88fd0c1c: raises $0.04 to $0.06
193c2885: folds
Uncalled bet ($0.04) returned to 88fd0c1c
*** SHOWDOWN ***
88fd0c1c collected $0.04 from pot
*** SUMMARY ***
Total pot $0.04 | Rake $0 | Jackpot $0 | Bingo $0
Seat 1: aa989090 (button) folded before Flop (didn't bet)
Seat 2: 88fd0c1c (small blind) collected ($0.04)
Seat 3: 193c2885 (big blind) folded before Flop
Seat 4: 223047eb folded before Flop (didn't bet)
Seat 5: 792e227 folded before Flop (didn't bet)
Seat 6: Hero folded before Flop (didn't bet)


Poker Hand #RC211922811: Omaha Pot Limit  ($0.01/$0.02) - 2022/10/21 12:13:16
Table 'RushAndCash1772811' 6-max Seat #1 is the button
Seat 1: 7cc03d50 ($2.13 in chips)
Seat 2: ec4663cd ($4.26 in chips)
Seat 3: f295722e ($6.35 in chips)
Seat 4: c10a0fbc ($2 in chips)
Seat 5: Hero ($1.54 in chips)
Seat 6: 3be5e736 ($2.18 in chips)
ec4663cd: posts small blind $0.01
f295722e: posts big blind $0.02
*** HOLE CARDS ***
Dealt to 7cc03d50 
Dealt to ec4663cd 
Dealt to f295722e 
Dealt to c10a0fbc 
Dealt to Hero [5s 4c 3d 7d]
Dealt to 3be5e736 
c10a0fbc: folds
Hero: folds
3be5e736: raises $0.05 to $0.07
7cc03d50: folds
ec4663cd: raises $0.16 to $0.23
f295722e: folds
3be5e736: calls $0.16
*** FLOP *** [8c 5c 9d]
ec4663cd: checks
3be5e736: checks
*** TURN *** [8c 5c 9d] [Ad]
ec4663cd: bets $0.48
3be5e736: folds
Uncalled bet ($0.48) returned to ec4663cd
*** SHOWDOWN ***
ec4663cd collected $0.46 from pot
*** SUMMARY ***
Total pot $0.48 | Rake $0.02 | Jackpot $0 | Bingo $0
Board [8c 5c 9d Ad]
Seat 1: 7cc03d50 (button) folded before Flop (didn't bet)
Seat 2: ec4663cd (small blind) won ($0.46)
Seat 3: f295722e (big blind) folded before Flop
Seat 4: c10a0fbc folded before Flop (didn't bet)
Seat 5: Hero folded before Flop (didn't bet)
Seat 6: 3be5e736 folded on the Turn


Poker Hand #RC211922806: Omaha Pot Limit  ($0.01/$0.02) - 2022/10/21 12:13:13
Table 'RushAndCash1772806' 6-max Seat #1 is the button
Seat 1: 996c9825 ($3.37 in chips)
Seat 2: ffc37f86 ($0.57 in chips)
Seat 3: b065516c ($2.02 in chips)
Seat 4: 971ded4e ($2.14 in chips)
Seat 5: Hero ($1.54 in chips)
Seat 6: 59e81d80 ($1.64 in chips)
ffc37f86: posts small blind $0.01
b065516c: posts big blind $0.02
*** HOLE CARDS ***
Dealt to 996c9825 
Dealt to ffc37f86 
Dealt to b065516c 
Dealt to 971ded4e 
Dealt to Hero [5d 3s 9d Jh]
Dealt to 59e81d80 
971ded4e: folds
Hero: folds
59e81d80: folds
996c9825: folds
ffc37f86: calls $0.01
b065516c: checks
*** FLOP *** [Qh 9c Kc]
ffc37f86: bets $0.02
b065516c: folds
Uncalled bet ($0.02) returned to ffc37f86
*** SHOWDOWN ***
ffc37f86 collected $0.04 from pot
*** SUMMARY ***
Total pot $0.04 | Rake $0 | Jackpot $0 | Bingo $0
Board [Qh 9c Kc]
Seat 1: 996c9825 (button) folded before Flop (didn't bet)
Seat 2: ffc37f86 (small blind) won ($0.04)
Seat 3: b065516c (big blind) folded on the Flop
Seat 4: 971ded4e folded before Flop (didn't bet)
Seat 5: Hero folded before Flop (didn't bet)
Seat 6: 59e81d80 folded before Flop (didn't bet)


Poker Hand #RC211922802: Omaha Pot Limit  ($0.01/$0.02) - 2022/10/21 12:13:10
Table 'RushAndCash1772802' 6-max Seat #1 is the button
Seat 1: d4099468 ($2 in chips)
Seat 2: Hero ($1.55 in chips)
Seat 3: 96bbebbc ($3.07 in chips)
Seat 4: e1bcdb2a ($4.12 in chips)
Seat 5: c78c8823 ($3.42 in chips)
Seat 6: 3391c12a ($1.97 in chips)
Hero: posts small blind $0.01
96bbebbc: posts big blind $0.02
*** HOLE CARDS ***
Dealt to d4099468 
Dealt to Hero [5c 6s Kc 2d]
Dealt to 96bbebbc 
Dealt to e1bcdb2a 
Dealt to c78c8823 
Dealt to 3391c12a 
e1bcdb2a: folds
c78c8823: raises $0.02 to $0.04
3391c12a: folds
d4099468: folds
Hero: folds
96bbebbc: calls $0.02
*** FLOP *** [8d 5d 9s]
96bbebbc: checks
c78c8823: bets $0.02
96bbebbc: calls $0.02
*** TURN *** [8d 5d 9s] [3h]
96bbebbc: checks
c78c8823: checks
*** RIVER *** [8d 5d 9s 3h] [7d]
96bbebbc: bets $0.02
c78c8823: calls $0.02
96bbebbc: shows [2h Ts Kd Jd] (King High Flush)
c78c8823: shows [Kh 4c Ks 2s] (Pair of Kings)
*** SHOWDOWN ***
96bbebbc collected $0.17 from pot
*** SUMMARY ***
Total pot $0.17 | Rake $0 | Jackpot $0 | Bingo $0
Board [8d 5d 9s 3h 7d]
Seat 1: d4099468 (button) folded before Flop (didn't bet)
Seat 2: Hero (small blind) folded before Flop
Seat 3: 96bbebbc (big blind) showed [2h Ts Kd Jd] and won ($0.17) with King High Flush
Seat 4: e1bcdb2a folded before Flop (didn't bet)
Seat 5: c78c8823 showed [Kh 4c Ks 2s] and lost with Pair of Kings
Seat 6: 3391c12a folded before Flop (didn't bet)


Poker Hand #RC211922708: Omaha Pot Limit  ($0.01/$0.02) - 2022/10/21 12:12:22
Table 'RushAndCash1772708' 6-max Seat #1 is the button
Seat 1: 6e3b1813 ($10.67 in chips)
Seat 2: d4099468 ($2 in chips)
Seat 3: Hero ($1.44 in chips)
Seat 4: 98a1ebf0 ($2.35 in chips)
Seat 5: 27602231 ($2.45 in chips)
Seat 6: d8113efd ($2 in chips)
d4099468: posts small blind $0.01
Hero: posts big blind $0.02
*** HOLE CARDS ***
Dealt to 6e3b1813 
Dealt to d4099468 
Dealt to Hero [9d As 4c Ac]
Dealt to 98a1ebf0 
Dealt to 27602231 
Dealt to d8113efd 
98a1ebf0: folds
27602231: folds
d8113efd: folds
6e3b1813: folds
d4099468: raises $0.04 to $0.06
Hero: calls $0.04
*** FLOP *** [Qc 2h 8s]
d4099468: checks
Hero: bets $0.06
d4099468: calls $0.06
*** TURN *** [Qc 2h 8s] [Ks]
d4099468: checks
Hero: checks
*** RIVER *** [Qc 2h 8s Ks] [7c]
d4099468: checks
Hero: checks
d4099468: shows [4h Js 9h Ts] (King-High)
Hero: shows [9d As 4c Ac] (Pair of Aces)
*** SHOWDOWN ***
Hero collected $0.23 from pot
*** SUMMARY ***
Total pot $0.24 | Rake $0.01 | Jackpot $0 | Bingo $0
Board [Qc 2h 8s Ks 7c]
Seat 1: 6e3b1813 (button) folded before Flop (didn't bet)
Seat 2: d4099468 (small blind) showed [4h Js 9h Ts] and lost with King-High
Seat 3: Hero (big blind) showed [9d As 4c Ac] and won ($0.23) with Pair of Aces
Seat 4: 98a1ebf0 folded before Flop (didn't bet)
Seat 5: 27602231 folded before Flop (didn't bet)
Seat 6: d8113efd folded before Flop (didn't bet)


Poker Hand #RC211922696: Omaha Pot Limit  ($0.01/$0.02) - 2022/10/21 12:12:14
Table 'RushAndCash1772696' 6-max Seat #1 is the button
Seat 1: 23f22ddc ($2.05 in chips)
Seat 2: 7cf97e5c ($2 in chips)
Seat 3: 88fd0c1c ($5.98 in chips)
Seat 4: 8e20ec5c ($3.7 in chips)
Seat 5: f96cd1a8 ($2.3 in chips)
Seat 6: Hero ($1.44 in chips)
7cf97e5c: posts small blind $0.01
88fd0c1c: posts big blind $0.02
*** HOLE CARDS ***
Dealt to 23f22ddc 
Dealt to 7cf97e5c 
Dealt to 88fd0c1c 
Dealt to 8e20ec5c 
Dealt to f96cd1a8 
Dealt to Hero [9s Jc 6h Qd]
8e20ec5c: folds
f96cd1a8: folds
Hero: folds
23f22ddc: folds
7cf97e5c: folds
Uncalled bet ($0.01) returned to 88fd0c1c
*** SHOWDOWN ***
88fd0c1c collected $0.02 from pot
*** SUMMARY ***
Total pot $0.02 | Rake $0 | Jackpot $0 | Bingo $0
Seat 1: 23f22ddc (button) folded before Flop (didn't bet)
Seat 2: 7cf97e5c (small blind) folded before Flop
Seat 3: 88fd0c1c (big blind) collected ($0.02)
Seat 4: 8e20ec5c folded before Flop (didn't bet)
Seat 5: f96cd1a8 folded before Flop (didn't bet)
Seat 6: Hero folded before Flop (didn't bet)


Poker Hand #RC211922522: Omaha Pot Limit  ($0.01/$0.02) - 2022/10/21 12:10:50
Table 'RushAndCash1772522' 6-max Seat #1 is the button
Seat 1: Hero ($1.95 in chips)
Seat 2: 2a063d61 ($0.28 in chips)
Seat 3: 9b781057 ($2.52 in chips)
Seat 4: f96cd1a8 ($1.84 in chips)
Seat 5: e1bcdb2a ($4.03 in chips)
Seat 6: e294ba0b ($1.8 in chips)
2a063d61: posts small blind $0.01
9b781057: posts big blind $0.02
*** HOLE CARDS ***
Dealt to Hero [Qs 5d Ad 3s]
Dealt to 2a063d61 
Dealt to 9b781057 
Dealt to f96cd1a8 
Dealt to e1bcdb2a 
Dealt to e294ba0b 
f96cd1a8: calls $0.02
e1bcdb2a: folds
e294ba0b: folds
Hero: raises $0.07 to $0.09
2a063d61: folds
9b781057: folds
f96cd1a8: calls $0.07
*** FLOP *** [Ah 8d Qc]
f96cd1a8: checks
Hero: bets $0.21
f96cd1a8: calls $0.21
*** TURN *** [Ah 8d Qc] [Jh]
f96cd1a8: checks
Hero: checks
*** RIVER *** [Ah 8d Qc Jh] [5s]
f96cd1a8: bets $0.21
Hero: calls $0.21
f96cd1a8: shows [Th 9d 9c Jd] (Queens-High Straight)
Hero: shows [Qs 5d Ad 3s] (Pair of Aces and Pair of Queens)
*** SHOWDOWN ***
f96cd1a8 collected $0.97 from pot
*** SUMMARY ***
Total pot $1.05 | Rake $0.05 | Jackpot $0.03 | Bingo $0
Board [Ah 8d Qc Jh 5s]
Seat 1: Hero (button) showed [Qs 5d Ad 3s] and lost with Pair of Aces and Pair of Queens
Seat 2: 2a063d61 (small blind) folded before Flop
Seat 3: 9b781057 (big blind) folded before Flop
Seat 4: f96cd1a8 showed [Th 9d 9c Jd] and won ($0.97) with Queens-High Straight
Seat 5: e1bcdb2a folded before Flop (didn't bet)
Seat 6: e294ba0b folded before Flop (didn't bet)


Poker Hand #RC211922512: Omaha Pot Limit  ($0.01/$0.02) - 2022/10/21 12:10:45
Table 'RushAndCash1772512' 6-max Seat #1 is the button
Seat 1: 4a6d01cb ($0.41 in chips)
Seat 2: b07fa5fc ($2.82 in chips)
Seat 3: 223047eb ($2.05 in chips)
Seat 4: Hero ($1.95 in chips)
Seat 5: 97978ed ($2.41 in chips)
Seat 6: e294ba0b ($1.8 in chips)
b07fa5fc: posts small blind $0.01
223047eb: posts big blind $0.02
*** HOLE CARDS ***
Dealt to 4a6d01cb 
Dealt to b07fa5fc 
Dealt to 223047eb 
Dealt to Hero [9h 9c Qd Jh]
Dealt to 97978ed 
Dealt to e294ba0b 
Hero: folds
97978ed: folds
e294ba0b: folds
4a6d01cb: folds
b07fa5fc: folds
Uncalled bet ($0.01) returned to 223047eb
*** SHOWDOWN ***
223047eb collected $0.02 from pot
*** SUMMARY ***
Total pot $0.02 | Rake $0 | Jackpot $0 | Bingo $0
Seat 1: 4a6d01cb (button) folded before Flop (didn't bet)
Seat 2: b07fa5fc (small blind) folded before Flop
Seat 3: 223047eb (big blind) collected ($0.02)
Seat 4: Hero folded before Flop (didn't bet)
Seat 5: 97978ed folded before Flop (didn't bet)
Seat 6: e294ba0b folded before Flop (didn't bet)


Poker Hand #RC211922500: Omaha Pot Limit  ($0.01/$0.02) - 2022/10/21 12:10:39
Table 'RushAndCash1772500' 6-max Seat #1 is the button
Seat 1: 525ab364 ($1.79 in chips)
Seat 2: 837fb000 ($1.98 in chips)
Seat 3: 3be5e736 ($1.96 in chips)
Seat 4: 2876d9d6 ($3.46 in chips)
Seat 5: 996c9825 ($2.84 in chips)
Seat 6: Hero ($1.95 in chips)
837fb000: posts small blind $0.01
3be5e736: posts big blind $0.02
*** HOLE CARDS ***
Dealt to 525ab364 
Dealt to 837fb000 
Dealt to 3be5e736 
Dealt to 2876d9d6 
Dealt to 996c9825 
Dealt to Hero [5c 4s Jh 2s]
2876d9d6: folds
996c9825: folds
Hero: folds
525ab364: raises $0.05 to $0.07
837fb000: folds
3be5e736: folds
Uncalled bet ($0.05) returned to 525ab364
*** SHOWDOWN ***
525ab364 collected $0.05 from pot
*** SUMMARY ***
Total pot $0.05 | Rake $0 | Jackpot $0 | Bingo $0
Seat 1: 525ab364 (button) collected ($0.05)
Seat 2: 837fb000 (small blind) folded before Flop
Seat 3: 3be5e736 (big blind) folded before Flop
Seat 4: 2876d9d6 folded before Flop (didn't bet)
Seat 5: 996c9825 folded before Flop (didn't bet)
Seat 6: Hero folded before Flop (didn't bet)


Poker Hand #RC211922493: Omaha Pot Limit  ($0.01/$0.02) - 2022/10/21 12:10:36
Table 'RushAndCash1772493' 6-max Seat #1 is the button
Seat 1: Hero ($1.95 in chips)
Seat 2: f96cd1a8 ($1.85 in chips)
Seat 3: aa88fa2d ($5.66 in chips)
Seat 4: 2876d9d6 ($3.46 in chips)
Seat 5: 1a8ba4a ($7.95 in chips)
Seat 6: 296c00d6 ($2.32 in chips)
f96cd1a8: posts small blind $0.01
aa88fa2d: posts big blind $0.02
*** HOLE CARDS ***
Dealt to Hero [8d 8c 5s Th]
Dealt to f96cd1a8 
Dealt to aa88fa2d 
Dealt to 2876d9d6 
Dealt to 1a8ba4a 
Dealt to 296c00d6 
2876d9d6: folds
1a8ba4a: folds
296c00d6: raises $0.04 to $0.06
Hero: folds
f96cd1a8: folds
aa88fa2d: folds
Uncalled bet ($0.04) returned to 296c00d6
*** SHOWDOWN ***
296c00d6 collected $0.05 from pot
*** SUMMARY ***
Total pot $0.05 | Rake $0 | Jackpot $0 | Bingo $0
Seat 1: Hero (button) folded before Flop (didn't bet)
Seat 2: f96cd1a8 (small blind) folded before Flop
Seat 3: aa88fa2d (big blind) folded before Flop
Seat 4: 2876d9d6 folded before Flop (didn't bet)
Seat 5: 1a8ba4a folded before Flop (didn't bet)
Seat 6: 296c00d6 collected ($0.05)


Poker Hand #RC211922486: Omaha Pot Limit  ($0.01/$0.02) - 2022/10/21 12:10:33
Table 'RushAndCash1772486' 6-max Seat #1 is the button
Seat 1: ba1595bf ($1.22 in chips)
Seat 2: Hero ($1.96 in chips)
Seat 3: c85bfbba ($1.99 in chips)
Seat 4: ffe38b0e ($2.42 in chips)
Seat 5: 6c540336 ($2.4 in chips)
Seat 6: 88fd0c1c ($3.22 in chips)
Hero: posts small blind $0.01
c85bfbba: posts big blind $0.02
*** HOLE CARDS ***
Dealt to ba1595bf 
Dealt to Hero [2d 2s 3c 9d]
Dealt to c85bfbba 
Dealt to ffe38b0e 
Dealt to 6c540336 
Dealt to 88fd0c1c 
ffe38b0e: raises $0.04 to $0.06
6c540336: folds
88fd0c1c: calls $0.06
ba1595bf: folds
Hero: folds
c85bfbba: calls $0.04
*** FLOP *** [8c 3s Td]
c85bfbba: checks
ffe38b0e: checks
88fd0c1c: bets $0.15
c85bfbba: raises $0.28 to $0.43
ffe38b0e: folds
88fd0c1c: folds
Uncalled bet ($0.28) returned to c85bfbba
*** SHOWDOWN ***
c85bfbba collected $0.47 from pot
*** SUMMARY ***
Total pot $0.49 | Rake $0.02 | Jackpot $0 | Bingo $0
Board [8c 3s Td]
Seat 1: ba1595bf (button) folded before Flop (didn't bet)
Seat 2: Hero (small blind) folded before Flop
Seat 3: c85bfbba (big blind) won ($0.47)
Seat 4: ffe38b0e folded on the Flop
Seat 5: 6c540336 folded before Flop (didn't bet)
Seat 6: 88fd0c1c folded on the Flop


Poker Hand #RC211921041: Omaha Pot Limit  ($0.01/$0.02) - 2022/10/21 11:58:04
Table 'RushAndCash1771041' 6-max Seat #1 is the button
Seat 1: c64ee214 ($1.87 in chips)
Seat 2: 1a8ba4a ($5.9 in chips)
Seat 3: Hero ($2 in chips)
Seat 4: c0930254 ($2 in chips)
Seat 5: 3381ab97 ($1.49 in chips)
Seat 6: 691b15b3 ($3.15 in chips)
1a8ba4a: posts small blind $0.01
Hero: posts big blind $0.02
*** HOLE CARDS ***
Dealt to c64ee214 
Dealt to 1a8ba4a 
Dealt to Hero [Th 7h 7d As]
Dealt to c0930254 
Dealt to 3381ab97 
Dealt to 691b15b3 
c0930254: folds
3381ab97: folds
691b15b3: raises $0.05 to $0.07
c64ee214: folds
1a8ba4a: folds
Hero: calls $0.05
*** FLOP *** [Qc 2s 6s]
Hero: checks
691b15b3: bets $0.12
Hero: folds
Uncalled bet ($0.12) returned to 691b15b3
*** SHOWDOWN ***
691b15b3 collected $0.15 from pot
*** SUMMARY ***
Total pot $0.15 | Rake $0 | Jackpot $0 | Bingo $0
Board [Qc 2s 6s]
Seat 1: c64ee214 (button) folded before Flop (didn't bet)
Seat 2: 1a8ba4a (small blind) folded before Flop
Seat 3: Hero (big blind) folded on the Flop
Seat 4: c0930254 folded before Flop (didn't bet)
Seat 5: 3381ab97 folded before Flop (didn't bet)
Seat 6: 691b15b3 won ($0.15)


Poker Hand #RC211921034: Omaha Pot Limit  ($0.01/$0.02) - 2022/10/21 11:58:01
Table 'RushAndCash1771034' 6-max Seat #1 is the button
Seat 1: be044eba ($4.2 in chips)
Seat 2: 8553cac6 ($5.15 in chips)
Seat 3: 3a8d7058 ($0.1 in chips)
Seat 4: Hero ($2 in chips)
Seat 5: eb187af5 ($2.12 in chips)
Seat 6: 1a8ba4a ($5.9 in chips)
8553cac6: posts small blind $0.01
3a8d7058: posts big blind $0.02
*** HOLE CARDS ***
Dealt to be044eba 
Dealt to 8553cac6 
Dealt to 3a8d7058 
Dealt to Hero [Ks 5d 4c 2s]
Dealt to eb187af5 
Dealt to 1a8ba4a 
Hero: folds
eb187af5: folds
1a8ba4a: folds
be044eba: folds
8553cac6: folds
Uncalled bet ($0.01) returned to 3a8d7058
*** SHOWDOWN ***
3a8d7058 collected $0.02 from pot
*** SUMMARY ***
Total pot $0.02 | Rake $0 | Jackpot $0 | Bingo $0
Seat 1: be044eba (button) folded before Flop (didn't bet)
Seat 2: 8553cac6 (small blind) folded before Flop
Seat 3: 3a8d7058 (big blind) collected ($0.02)
Seat 4: Hero folded before Flop (didn't bet)
Seat 5: eb187af5 folded before Flop (didn't bet)
Seat 6: 1a8ba4a folded before Flop (didn't bet)


Poker Hand #RC211921029: Omaha Pot Limit  ($0.01/$0.02) - 2022/10/21 11:57:57
Table 'RushAndCash1771029' 6-max Seat #1 is the button
Seat 1: 2d957a1c ($1.43 in chips)
Seat 2: 185ba609 ($11.1 in chips)
Seat 3: 582a77b7 ($2.3 in chips)
Seat 4: 196e9263 ($3.54 in chips)
Seat 5: Hero ($2 in chips)
Seat 6: 11c44f5e ($1.1 in chips)
185ba609: posts small blind $0.01
582a77b7: posts big blind $0.02
*** HOLE CARDS ***
Dealt to 2d957a1c 
Dealt to 185ba609 
Dealt to 582a77b7 
Dealt to 196e9263 
Dealt to Hero [Qh 5d 4h Qs]
Dealt to 11c44f5e 
196e9263: folds
Hero: folds
11c44f5e: folds
2d957a1c: folds
185ba609: folds
Uncalled bet ($0.01) returned to 582a77b7
*** SHOWDOWN ***
582a77b7 collected $0.02 from pot
*** SUMMARY ***
Total pot $0.02 | Rake $0 | Jackpot $0 | Bingo $0
Seat 1: 2d957a1c (button) folded before Flop (didn't bet)
Seat 2: 185ba609 (small blind) folded before Flop
Seat 3: 582a77b7 (big blind) collected ($0.02)
Seat 4: 196e9263 folded before Flop (didn't bet)
Seat 5: Hero folded before Flop (didn't bet)
Seat 6: 11c44f5e folded before Flop (didn't bet)


Poker Hand #RC211921022: Omaha Pot Limit  ($0.01/$0.02) - 2022/10/21 11:57:52
Table 'RushAndCash1771022' 6-max Seat #1 is the button
Seat 1: 40974004 ($4.41 in chips)
Seat 2: 837fb000 ($1.33 in chips)
Seat 3: aece90cc ($2 in chips)
Seat 4: Hero ($2 in chips)
Seat 5: 11c44f5e ($1.1 in chips)
Seat 6: 45bc3a44 ($2.08 in chips)
837fb000: posts small blind $0.01
aece90cc: posts big blind $0.02
*** HOLE CARDS ***
Dealt to 40974004 
Dealt to 837fb000 
Dealt to aece90cc 
Dealt to Hero [4c Kd Qh Ks]
Dealt to 11c44f5e 
Dealt to 45bc3a44 
Hero: folds
11c44f5e: folds
45bc3a44: folds
40974004: raises $0.02 to $0.04
837fb000: calls $0.03
aece90cc: calls $0.02
*** FLOP *** [Ts 4h 2s]
837fb000: checks
aece90cc: checks
40974004: checks
*** TURN *** [Ts 4h 2s] [Qd]
837fb000: bets $0.12
aece90cc: calls $0.12
40974004: folds
*** RIVER *** [Ts 4h 2s Qd] [3s]
837fb000: checks
aece90cc: bets $0.18
837fb000: folds
Uncalled bet ($0.18) returned to aece90cc
*** SHOWDOWN ***
aece90cc collected $0.35 from pot
*** SUMMARY ***
Total pot $0.36 | Rake $0.01 | Jackpot $0 | Bingo $0
Board [Ts 4h 2s Qd 3s]
Seat 1: 40974004 (button) folded on the Turn
Seat 2: 837fb000 (small blind) folded on the River
Seat 3: aece90cc (big blind) won ($0.35)
Seat 4: Hero folded before Flop (didn't bet)
Seat 5: 11c44f5e folded before Flop (didn't bet)
Seat 6: 45bc3a44 folded before Flop (didn't bet)


Poker Hand #RC211921016: Omaha Pot Limit  ($0.01/$0.02) - 2022/10/21 11:57:48
Table 'RushAndCash1771016' 6-max Seat #1 is the button
Seat 1: Hero ($2 in chips)
Seat 2: 360f356c ($3.73 in chips)
Seat 3: eb187af5 ($2.14 in chips)
Seat 4: 71bf1949 ($1.29 in chips)
Seat 5: 5d010df7 ($0.61 in chips)
Seat 6: 40974004 ($4.41 in chips)
360f356c: posts small blind $0.01
eb187af5: posts big blind $0.02
*** HOLE CARDS ***
Dealt to Hero [6c Jc Ac 7d]
Dealt to 360f356c 
Dealt to eb187af5 
Dealt to 71bf1949 
Dealt to 5d010df7 
Dealt to 40974004 
71bf1949: folds
5d010df7: folds
40974004: folds
Hero: folds
360f356c: raises $0.02 to $0.04
eb187af5: folds
Uncalled bet ($0.02) returned to 360f356c
*** SHOWDOWN ***
360f356c collected $0.04 from pot
*** SUMMARY ***
Total pot $0.04 | Rake $0 | Jackpot $0 | Bingo $0
Seat 1: Hero (button) folded before Flop (didn't bet)
Seat 2: 360f356c (small blind) collected ($0.04)
Seat 3: eb187af5 (big blind) folded before Flop
Seat 4: 71bf1949 folded before Flop (didn't bet)
Seat 5: 5d010df7 folded before Flop (didn't bet)
Seat 6: 40974004 folded before Flop (didn't bet)


Poker Hand #RC211921008: Omaha Pot Limit  ($0.01/$0.02) - 2022/10/21 11:57:44
Table 'RushAndCash1771008' 6-max Seat #1 is the button
Seat 1: 971ded4e ($2 in chips)
Seat 2: eb187af5 ($2.15 in chips)
Seat 3: Hero ($2.02 in chips)
Seat 4: 159180db ($2.03 in chips)
Seat 5: eec155ea ($2.45 in chips)
Seat 6: be044eba ($4.2 in chips)
eb187af5: posts small blind $0.01
Hero: posts big blind $0.02
*** HOLE CARDS ***
Dealt to 971ded4e 
Dealt to eb187af5 
Dealt to Hero [7d Qc 4d As]
Dealt to 159180db 
Dealt to eec155ea 
Dealt to be044eba 
159180db: folds
eec155ea: folds
be044eba: folds
971ded4e: folds
eb187af5: folds
Uncalled bet ($0.01) returned to Hero
*** SHOWDOWN ***
Hero collected $0.02 from pot
*** SUMMARY ***
Total pot $0.02 | Rake $0 | Jackpot $0 | Bingo $0
Seat 1: 971ded4e (button) folded before Flop (didn't bet)
Seat 2: eb187af5 (small blind) folded before Flop
Seat 3: Hero (big blind) collected ($0.02)
Seat 4: 159180db folded before Flop (didn't bet)
Seat 5: eec155ea folded before Flop (didn't bet)
Seat 6: be044eba folded before Flop (didn't bet)


Poker Hand #RC211921001: Omaha Pot Limit  ($0.01/$0.02) - 2022/10/21 11:57:40
Table 'RushAndCash1771001' 6-max Seat #1 is the button
Seat 1: 9df7c63c ($8.66 in chips)
Seat 2: Hero ($2.03 in chips)
Seat 3: 837fb000 ($1.32 in chips)
Seat 4: 159180db ($2.03 in chips)
Seat 5: 71c24ec5 ($4.85 in chips)
Seat 6: 971ded4e ($2 in chips)
Hero: posts small blind $0.01
837fb000: posts big blind $0.02
*** HOLE CARDS ***
Dealt to 9df7c63c 
Dealt to Hero [Qd 6h Ts 7s]
Dealt to 837fb000 
Dealt to 159180db 
Dealt to 71c24ec5 
Dealt to 971ded4e 
159180db: folds
71c24ec5: folds
971ded4e: folds
9df7c63c: folds
Hero: folds
Uncalled bet ($0.01) returned to 837fb000
*** SHOWDOWN ***
837fb000 collected $0.02 from pot
*** SUMMARY ***
Total pot $0.02 | Rake $0 | Jackpot $0 | Bingo $0
Seat 1: 9df7c63c (button) folded before Flop (didn't bet)
Seat 2: Hero (small blind) folded before Flop
Seat 3: 837fb000 (big blind) collected ($0.02)
Seat 4: 159180db folded before Flop (didn't bet)
Seat 5: 71c24ec5 folded before Flop (didn't bet)
Seat 6: 971ded4e folded before Flop (didn't bet)


Poker Hand #RC211920994: Omaha Pot Limit  ($0.01/$0.02) - 2022/10/21 11:57:36
Table 'RushAndCash1770994' 6-max Seat #1 is the button
Seat 1: 9b781057 ($2.01 in chips)
Seat 2: 76b0f983 ($8.78 in chips)
Seat 3: 98a1ebf0 ($2 in chips)
Seat 4: 9df7c63c ($8.66 in chips)
Seat 5: Hero ($2.03 in chips)
Seat 6: eb187af5 ($2.15 in chips)
76b0f983: posts small blind $0.01
98a1ebf0: posts big blind $0.02
*** HOLE CARDS ***
Dealt to 9b781057 
Dealt to 76b0f983 
Dealt to 98a1ebf0 
Dealt to 9df7c63c 
Dealt to Hero [Qc 7h 3s 4c]
Dealt to eb187af5 
9df7c63c: folds
Hero: folds
eb187af5: folds
9b781057: raises $0.02 to $0.04
76b0f983: raises $0.06 to $0.1
98a1ebf0: folds
9b781057: calls $0.06
*** FLOP *** [2d 9d 5d]
76b0f983: bets $0.08
9b781057: folds
Uncalled bet ($0.08) returned to 76b0f983
*** SHOWDOWN ***
76b0f983 collected $0.21 from pot
*** SUMMARY ***
Total pot $0.22 | Rake $0.01 | Jackpot $0 | Bingo $0
Board [2d 9d 5d]
Seat 1: 9b781057 (button) folded on the Flop
Seat 2: 76b0f983 (small blind) won ($0.21)
Seat 3: 98a1ebf0 (big blind) folded before Flop
Seat 4: 9df7c63c folded before Flop (didn't bet)
Seat 5: Hero folded before Flop (didn't bet)
Seat 6: eb187af5 folded before Flop (didn't bet)


Poker Hand #RC211920988: Omaha Pot Limit  ($0.01/$0.02) - 2022/10/21 11:57:32
Table 'RushAndCash1770988' 6-max Seat #1 is the button
Seat 1: 23f22ddc ($2.55 in chips)
Seat 2: cdc6c025 ($5.92 in chips)
Seat 3: 2898300f ($4.24 in chips)
Seat 4: 91d62fa5 ($2 in chips)
Seat 5: 971ded4e ($2 in chips)
Seat 6: Hero ($2.03 in chips)
cdc6c025: posts small blind $0.01
2898300f: posts big blind $0.02
*** HOLE CARDS ***
Dealt to 23f22ddc 
Dealt to cdc6c025 
Dealt to 2898300f 
Dealt to 91d62fa5 
Dealt to 971ded4e 
Dealt to Hero [9s Js Jd 5s]
91d62fa5: raises $0.05 to $0.07
971ded4e: folds
Hero: folds
23f22ddc: folds
cdc6c025: calls $0.06
2898300f: calls $0.05
*** FLOP *** [2d 7h 3d]
cdc6c025: checks
2898300f: bets $0.04
91d62fa5: folds
cdc6c025: calls $0.04
*** TURN *** [2d 7h 3d] [9d]
cdc6c025: checks
2898300f: checks
*** RIVER *** [2d 7h 3d 9d] [Tc]
cdc6c025: bets $0.29
2898300f: folds
Uncalled bet ($0.29) returned to cdc6c025
*** SHOWDOWN ***
cdc6c025 collected $0.28 from pot
*** SUMMARY ***
Total pot $0.29 | Rake $0.01 | Jackpot $0 | Bingo $0
Board [2d 7h 3d 9d Tc]
Seat 1: 23f22ddc (button) folded before Flop (didn't bet)
Seat 2: cdc6c025 (small blind) won ($0.28)
Seat 3: 2898300f (big blind) folded on the River
Seat 4: 91d62fa5 folded on the Flop
Seat 5: 971ded4e folded before Flop (didn't bet)
Seat 6: Hero folded before Flop (didn't bet)


Poker Hand #RC211920982: Omaha Pot Limit  ($0.01/$0.02) - 2022/10/21 11:57:28
Table 'RushAndCash1770982' 6-max Seat #1 is the button
Seat 1: 86010f0f ($6.2 in chips)
Seat 2: ff14d553 ($1.75 in chips)
Seat 3: 176be170 ($1.41 in chips)
Seat 4: 8cb8a924 ($4.34 in chips)
Seat 5: Hero ($2.03 in chips)
Seat 6: 21b49385 ($2.72 in chips)
ff14d553: posts small blind $0.01
176be170: posts big blind $0.02
*** HOLE CARDS ***
Dealt to 86010f0f 
Dealt to ff14d553 
Dealt to 176be170 
Dealt to 8cb8a924 
Dealt to Hero [4d 3s Qh Ac]
Dealt to 21b49385 
8cb8a924: folds
Hero: folds
21b49385: raises $0.04 to $0.06
86010f0f: folds
ff14d553: folds
176be170: folds
Uncalled bet ($0.04) returned to 21b49385
*** SHOWDOWN ***
21b49385 collected $0.05 from pot
*** SUMMARY ***
Total pot $0.05 | Rake $0 | Jackpot $0 | Bingo $0
Seat 1: 86010f0f (button) folded before Flop (didn't bet)
Seat 2: ff14d553 (small blind) folded before Flop
Seat 3: 176be170 (big blind) folded before Flop
Seat 4: 8cb8a924 folded before Flop (didn't bet)
Seat 5: Hero folded before Flop (didn't bet)
Seat 6: 21b49385 collected ($0.05)


Poker Hand #RC211920964: Omaha Pot Limit  ($0.01/$0.02) - 2022/10/21 11:57:18
Table 'RushAndCash1770964' 6-max Seat #1 is the button
Seat 1: Hero ($2.03 in chips)
Seat 2: 21b49385 ($2.73 in chips)
Seat 3: c64ee214 ($1.87 in chips)
Seat 4: 18acf854 ($1.86 in chips)
Seat 5: aa88fa2d ($3.33 in chips)
Seat 6: 193c2885 ($5.94 in chips)
21b49385: posts small blind $0.01
c64ee214: posts big blind $0.02
*** HOLE CARDS ***
Dealt to Hero [2h 9d Kd 9c]
Dealt to 21b49385 
Dealt to c64ee214 
Dealt to 18acf854 
Dealt to aa88fa2d 
Dealt to 193c2885 
18acf854: folds
aa88fa2d: raises $0.05 to $0.07
193c2885: folds
Hero: folds
21b49385: folds
c64ee214: folds
Uncalled bet ($0.05) returned to aa88fa2d
*** SHOWDOWN ***
aa88fa2d collected $0.05 from pot
*** SUMMARY ***
Total pot $0.05 | Rake $0 | Jackpot $0 | Bingo $0
Seat 1: Hero (button) folded before Flop (didn't bet)
Seat 2: 21b49385 (small blind) folded before Flop
Seat 3: c64ee214 (big blind) folded before Flop
Seat 4: 18acf854 folded before Flop (didn't bet)
Seat 5: aa88fa2d collected ($0.05)
Seat 6: 193c2885 folded before Flop (didn't bet)


Poker Hand #RC211920958: Omaha Pot Limit  ($0.01/$0.02) - 2022/10/21 11:57:15
Table 'RushAndCash1770958' 6-max Seat #1 is the button
Seat 1: 176be170 ($1.41 in chips)
Seat 2: 59e81d80 ($1.98 in chips)
Seat 3: Hero ($2.05 in chips)
Seat 4: 525ab364 ($2.5 in chips)
Seat 5: 94fd55e5 ($3.71 in chips)
Seat 6: 95a39865 ($3.18 in chips)
59e81d80: posts small blind $0.01
Hero: posts big blind $0.02
*** HOLE CARDS ***
Dealt to 176be170 
Dealt to 59e81d80 
Dealt to Hero [6h 3c Js 5c]
Dealt to 525ab364 
Dealt to 94fd55e5 
Dealt to 95a39865 
525ab364: folds
94fd55e5: folds
95a39865: folds
176be170: folds
59e81d80: raises $0.02 to $0.04
Hero: folds
Uncalled bet ($0.02) returned to 59e81d80
*** SHOWDOWN ***
59e81d80 collected $0.04 from pot
*** SUMMARY ***
Total pot $0.04 | Rake $0 | Jackpot $0 | Bingo $0
Seat 1: 176be170 (button) folded before Flop (didn't bet)
Seat 2: 59e81d80 (small blind) collected ($0.04)
Seat 3: Hero (big blind) folded before Flop
Seat 4: 525ab364 folded before Flop (didn't bet)
Seat 5: 94fd55e5 folded before Flop (didn't bet)
Seat 6: 95a39865 folded before Flop (didn't bet)


Poker Hand #RC211920953: Omaha Pot Limit  ($0.01/$0.02) - 2022/10/21 11:57:11
Table 'RushAndCash1770953' 6-max Seat #1 is the button
Seat 1: 7cc03d50 ($2.34 in chips)
Seat 2: Hero ($2.06 in chips)
Seat 3: 59e81d80 ($2 in chips)
Seat 4: 96df8779 ($5.08 in chips)
Seat 5: 94fd55e5 ($3.71 in chips)
Seat 6: bac1f0b3 ($11.51 in chips)
Hero: posts small blind $0.01
59e81d80: posts big blind $0.02
*** HOLE CARDS ***
Dealt to 7cc03d50 
Dealt to Hero [Kc 4s 7c 9s]
Dealt to 59e81d80 
Dealt to 96df8779 
Dealt to 94fd55e5 
Dealt to bac1f0b3 
96df8779: folds
94fd55e5: folds
bac1f0b3: folds
7cc03d50: raises $0.02 to $0.04
Hero: folds
59e81d80: folds
Uncalled bet ($0.02) returned to 7cc03d50
*** SHOWDOWN ***
7cc03d50 collected $0.05 from pot
*** SUMMARY ***
Total pot $0.05 | Rake $0 | Jackpot $0 | Bingo $0
Seat 1: 7cc03d50 (button) collected ($0.05)
Seat 2: Hero (small blind) folded before Flop
Seat 3: 59e81d80 (big blind) folded before Flop
Seat 4: 96df8779 folded before Flop (didn't bet)
Seat 5: 94fd55e5 folded before Flop (didn't bet)
Seat 6: bac1f0b3 folded before Flop (didn't bet)


Poker Hand #RC211920946: Omaha Pot Limit  ($0.01/$0.02) - 2022/10/21 11:57:06
Table 'RushAndCash1770946' 6-max Seat #1 is the button
Seat 1: 2a063d61 ($0.35 in chips)
Seat 2: aa88fa2d ($3.34 in chips)
Seat 3: 71c24ec5 ($4.85 in chips)
Seat 4: f760f34f ($2.29 in chips)
Seat 5: 88a97221 ($2.23 in chips)
Seat 6: Hero ($2.06 in chips)
aa88fa2d: posts small blind $0.01
71c24ec5: posts big blind $0.02
*** HOLE CARDS ***
Dealt to 2a063d61 
Dealt to aa88fa2d 
Dealt to 71c24ec5 
Dealt to f760f34f 
Dealt to 88a97221 
Dealt to Hero [Jh As 4h Qh]
f760f34f: folds
88a97221: folds
Hero: folds
2a063d61: folds
aa88fa2d: folds
Uncalled bet ($0.01) returned to 71c24ec5
*** SHOWDOWN ***
71c24ec5 collected $0.02 from pot
*** SUMMARY ***
Total pot $0.02 | Rake $0 | Jackpot $0 | Bingo $0
Seat 1: 2a063d61 (button) folded before Flop (didn't bet)
Seat 2: aa88fa2d (small blind) folded before Flop
Seat 3: 71c24ec5 (big blind) collected ($0.02)
Seat 4: f760f34f folded before Flop (didn't bet)
Seat 5: 88a97221 folded before Flop (didn't bet)
Seat 6: Hero folded before Flop (didn't bet)


Poker Hand #RC211920940: Omaha Pot Limit  ($0.01/$0.02) - 2022/10/21 11:57:01
Table 'RushAndCash1770940' 6-max Seat #1 is the button
Seat 1: b37d22b5 ($2.34 in chips)
Seat 2: 2f2d4721 ($3.76 in chips)
Seat 3: 132715bc ($2.44 in chips)
Seat 4: ffe38b0e ($1.93 in chips)
Seat 5: Hero ($2.06 in chips)
Seat 6: d1a86b34 ($2.03 in chips)
2f2d4721: posts small blind $0.01
132715bc: posts big blind $0.02
*** HOLE CARDS ***
Dealt to b37d22b5 
Dealt to 2f2d4721 
Dealt to 132715bc 
Dealt to ffe38b0e 
Dealt to Hero [Th Qs 4c Kd]
Dealt to d1a86b34 
ffe38b0e: raises $0.04 to $0.06
Hero: folds
d1a86b34: folds
b37d22b5: folds
2f2d4721: folds
132715bc: calls $0.04
*** FLOP *** [8s 2c Ts]
132715bc: bets $0.09
ffe38b0e: calls $0.09
*** TURN *** [8s 2c Ts] [Jd]
132715bc: bets $0.16
ffe38b0e: folds
Uncalled bet ($0.16) returned to 132715bc
*** SHOWDOWN ***
132715bc collected $0.3 from pot
*** SUMMARY ***
Total pot $0.31 | Rake $0.01 | Jackpot $0 | Bingo $0
Board [8s 2c Ts Jd]
Seat 1: b37d22b5 (button) folded before Flop (didn't bet)
Seat 2: 2f2d4721 (small blind) folded before Flop
Seat 3: 132715bc (big blind) won ($0.3)
Seat 4: ffe38b0e folded on the Turn
Seat 5: Hero folded before Flop (didn't bet)
Seat 6: d1a86b34 folded before Flop (didn't bet)


Poker Hand #RC211920934: Omaha Pot Limit  ($0.01/$0.02) - 2022/10/21 11:56:58
Table 'RushAndCash1770934' 6-max Seat #1 is the button
Seat 1: efa6db66 ($2 in chips)
Seat 2: 4377f8af ($3.01 in chips)
Seat 3: a74b01c6 ($2 in chips)
Seat 4: 132715bc ($2.44 in chips)
Seat 5: bc70dc6 ($2 in chips)
Seat 6: Hero ($2.06 in chips)
4377f8af: posts small blind $0.01
a74b01c6: posts big blind $0.02
*** HOLE CARDS ***
Dealt to efa6db66 
Dealt to 4377f8af 
Dealt to a74b01c6 
Dealt to 132715bc 
Dealt to bc70dc6 
Dealt to Hero [3c Ts 2c 2d]
132715bc: folds
bc70dc6: folds
Hero: folds
efa6db66: folds
4377f8af: raises $0.04 to $0.06
a74b01c6: calls $0.04
*** FLOP *** [Qd 9d Ah]
4377f8af: checks
a74b01c6: bets $0.12
4377f8af: calls $0.12
*** TURN *** [Qd 9d Ah] [Th]
4377f8af: checks
a74b01c6: checks
*** RIVER *** [Qd 9d Ah Th] [Jc]
4377f8af: checks
a74b01c6: bets $0.36
4377f8af: folds
Uncalled bet ($0.36) returned to a74b01c6
*** SHOWDOWN ***
a74b01c6 collected $0.35 from pot
*** SUMMARY ***
Total pot $0.36 | Rake $0.01 | Jackpot $0 | Bingo $0
Board [Qd 9d Ah Th Jc]
Seat 1: efa6db66 (button) folded before Flop (didn't bet)
Seat 2: 4377f8af (small blind) folded on the River
Seat 3: a74b01c6 (big blind) won ($0.35)
Seat 4: 132715bc folded before Flop (didn't bet)
Seat 5: bc70dc6 folded before Flop (didn't bet)
Seat 6: Hero folded before Flop (didn't bet)


Poker Hand #RC211920928: Omaha Pot Limit  ($0.01/$0.02) - 2022/10/21 11:56:54
Table 'RushAndCash1770928' 6-max Seat #1 is the button
Seat 1: c46c3088 ($1.77 in chips)
Seat 2: efa6db66 ($2 in chips)
Seat 3: 23f22ddc ($2.55 in chips)
Seat 4: 78d1e655 ($3.24 in chips)
Seat 5: Hero ($2.06 in chips)
Seat 6: 599a53ee ($5.62 in chips)
efa6db66: posts small blind $0.01
23f22ddc: posts big blind $0.02
*** HOLE CARDS ***
Dealt to c46c3088 
Dealt to efa6db66 
Dealt to 23f22ddc 
Dealt to 78d1e655 
Dealt to Hero [Td Tc 3h 6c]
Dealt to 599a53ee 
78d1e655: raises $0.05 to $0.07
Hero: folds
599a53ee: calls $0.07
c46c3088: calls $0.07
efa6db66: folds
23f22ddc: folds
*** FLOP *** [3s Qs 4c]
78d1e655: bets $0.12
599a53ee: folds
c46c3088: calls $0.12
*** TURN *** [3s Qs 4c] [8c]
78d1e655: bets $0.24
c46c3088: calls $0.24
*** RIVER *** [3s Qs 4c 8c] [2s]
78d1e655: bets $0.48
c46c3088: calls $0.48
78d1e655: shows [Ts 8h As Ac] (Ace High Flush)
c46c3088: shows [7c Ah 6h 5d] (Sixes-High Straight)
*** SHOWDOWN ***
78d1e655 collected $1.83 from pot
*** SUMMARY ***
Total pot $1.92 | Rake $0.06 | Jackpot $0.03 | Bingo $0
Board [3s Qs 4c 8c 2s]
Seat 1: c46c3088 (button) showed [7c Ah 6h 5d] and lost with Sixes-High Straight
Seat 2: efa6db66 (small blind) folded before Flop
Seat 3: 23f22ddc (big blind) folded before Flop
Seat 4: 78d1e655 showed [Ts 8h As Ac] and won ($1.83) with Ace High Flush
Seat 5: Hero folded before Flop (didn't bet)
Seat 6: 599a53ee folded on the Flop


Poker Hand #RC211920922: Omaha Pot Limit  ($0.01/$0.02) - 2022/10/21 11:56:51
Table 'RushAndCash1770922' 6-max Seat #1 is the button
Seat 1: 7cc03d50 ($2.34 in chips)
Seat 2: Hero ($2.07 in chips)
Seat 3: 193c2885 ($5.98 in chips)
Seat 4: 38ddecaa ($1.27 in chips)
Seat 5: 91d62fa5 ($2.02 in chips)
Seat 6: 2df75ecf ($2.73 in chips)
Hero: posts small blind $0.01
193c2885: posts big blind $0.02
*** HOLE CARDS ***
Dealt to 7cc03d50 
Dealt to Hero [8c 2d Jh Qh]
Dealt to 193c2885 
Dealt to 38ddecaa 
Dealt to 91d62fa5 
Dealt to 2df75ecf 
38ddecaa: folds
91d62fa5: folds
2df75ecf: raises $0.05 to $0.07
7cc03d50: folds
Hero: folds
193c2885: folds
Uncalled bet ($0.05) returned to 2df75ecf
*** SHOWDOWN ***
2df75ecf collected $0.05 from pot
*** SUMMARY ***
Total pot $0.05 | Rake $0 | Jackpot $0 | Bingo $0
Seat 1: 7cc03d50 (button) folded before Flop (didn't bet)
Seat 2: Hero (small blind) folded before Flop
Seat 3: 193c2885 (big blind) folded before Flop
Seat 4: 38ddecaa folded before Flop (didn't bet)
Seat 5: 91d62fa5 folded before Flop (didn't bet)
Seat 6: 2df75ecf collected ($0.05)


Poker Hand #RC211920914: Omaha Pot Limit  ($0.01/$0.02) - 2022/10/21 11:56:46
Table 'RushAndCash1770914' 6-max Seat #1 is the button
Seat 1: 11c44f5e ($1.94 in chips)
Seat 2: 76378a1 ($1.95 in chips)
Seat 3: Hero ($2.09 in chips)
Seat 4: 4066da82 ($5.92 in chips)
Seat 5: d85c7b89 ($2 in chips)
Seat 6: 45bc3a44 ($1.24 in chips)
76378a1: posts small blind $0.01
Hero: posts big blind $0.02
*** HOLE CARDS ***
Dealt to 11c44f5e 
Dealt to 76378a1 
Dealt to Hero [4d 6d As 7s]
Dealt to 4066da82 
Dealt to d85c7b89 
Dealt to 45bc3a44 
4066da82: folds
d85c7b89: folds
45bc3a44: raises $0.05 to $0.07
11c44f5e: calls $0.07
76378a1: calls $0.06
Hero: folds
*** FLOP *** [Ts 9d 6c]
76378a1: checks
45bc3a44: bets $0.08
11c44f5e: raises $0.1 to $0.18
76378a1: folds
45bc3a44: calls $0.1
*** TURN *** [Ts 9d 6c] [Ad]
45bc3a44: bets $0.59
11c44f5e: calls $0.59
*** RIVER *** [Ts 9d 6c Ad] [7h]
45bc3a44: bets $0.4 and is all-in
11c44f5e: folds
Uncalled bet ($0.4) returned to 45bc3a44
*** SHOWDOWN ***
45bc3a44 collected $1.68 from pot
*** SUMMARY ***
Total pot $1.77 | Rake $0.06 | Jackpot $0.03 | Bingo $0
Board [Ts 9d 6c Ad 7h]
Seat 1: 11c44f5e (button) folded on the River
Seat 2: 76378a1 (small blind) folded on the Flop
Seat 3: Hero (big blind) folded before Flop
Seat 4: 4066da82 folded before Flop (didn't bet)
Seat 5: d85c7b89 folded before Flop (didn't bet)
Seat 6: 45bc3a44 won ($1.68)


Poker Hand #RC211920904: Omaha Pot Limit  ($0.01/$0.02) - 2022/10/21 11:56:42
Table 'RushAndCash1770904' 6-max Seat #1 is the button
Seat 1: Hero ($2.09 in chips)
Seat 2: 176be170 ($1.48 in chips)
Seat 3: 76378a1 ($1.97 in chips)
Seat 4: 7d3b146b ($1.56 in chips)
Seat 5: cfbaf2a9 ($2 in chips)
Seat 6: 9ecfcda0 ($2 in chips)
176be170: posts small blind $0.01
76378a1: posts big blind $0.02
*** HOLE CARDS ***
Dealt to Hero [Ts 7s Tc 2s]
Dealt to 176be170 
Dealt to 76378a1 
Dealt to 7d3b146b 
Dealt to cfbaf2a9 
Dealt to 9ecfcda0 
7d3b146b: folds
cfbaf2a9: folds
9ecfcda0: raises $0.05 to $0.07
Hero: folds
176be170: calls $0.06
76378a1: folds
*** FLOP *** [Qd 6d 9d]
176be170: checks
9ecfcda0: bets $0.12
176be170: folds
Uncalled bet ($0.12) returned to 9ecfcda0
*** SHOWDOWN ***
9ecfcda0 collected $0.16 from pot
*** SUMMARY ***
Total pot $0.16 | Rake $0 | Jackpot $0 | Bingo $0
Board [Qd 6d 9d]
Seat 1: Hero (button) folded before Flop (didn't bet)
Seat 2: 176be170 (small blind) folded on the Flop
Seat 3: 76378a1 (big blind) folded before Flop
Seat 4: 7d3b146b folded before Flop (didn't bet)
Seat 5: cfbaf2a9 folded before Flop (didn't bet)
Seat 6: 9ecfcda0 won ($0.16)


Poker Hand #RC211920898: Omaha Pot Limit  ($0.01/$0.02) - 2022/10/21 11:56:38
Table 'RushAndCash1770898' 6-max Seat #1 is the button
Seat 1: 8553cac6 ($5 in chips)
Seat 2: 391f869d ($1.71 in chips)
Seat 3: be044eba ($4.05 in chips)
Seat 4: Hero ($2.09 in chips)
Seat 5: ef250f8e ($3.22 in chips)
Seat 6: d687f3bb ($3.17 in chips)
391f869d: posts small blind $0.01
be044eba: posts big blind $0.02
*** HOLE CARDS ***
Dealt to 8553cac6 
Dealt to 391f869d 
Dealt to be044eba 
Dealt to Hero [5c Qd 5s 3c]
Dealt to ef250f8e 
Dealt to d687f3bb 
Hero: folds
ef250f8e: folds
d687f3bb: raises $0.04 to $0.06
8553cac6: folds
391f869d: folds
be044eba: calls $0.04
*** FLOP *** [7s Jc As]
be044eba: checks
d687f3bb: bets $0.1
be044eba: calls $0.1
*** TURN *** [7s Jc As] [3d]
be044eba: checks
d687f3bb: checks
*** RIVER *** [7s Jc As 3d] [Ad]
be044eba: bets $0.11
d687f3bb: folds
Uncalled bet ($0.11) returned to be044eba
*** SHOWDOWN ***
be044eba collected $0.32 from pot
*** SUMMARY ***
Total pot $0.33 | Rake $0.01 | Jackpot $0 | Bingo $0
Board [7s Jc As 3d Ad]
Seat 1: 8553cac6 (button) folded before Flop (didn't bet)
Seat 2: 391f869d (small blind) folded before Flop
Seat 3: be044eba (big blind) won ($0.32)
Seat 4: Hero folded before Flop (didn't bet)
Seat 5: ef250f8e folded before Flop (didn't bet)
Seat 6: d687f3bb folded on the River


Poker Hand #RC211920892: Omaha Pot Limit  ($0.01/$0.02) - 2022/10/21 11:56:35
Table 'RushAndCash1770892' 6-max Seat #1 is the button
Seat 1: a99c046 ($2.26 in chips)
Seat 2: 11c44f5e ($1.95 in chips)
Seat 3: 5537777d ($2 in chips)
Seat 4: Hero ($2.09 in chips)
Seat 5: 1b375f65 ($6.77 in chips)
Seat 6: ef250f8e ($3.22 in chips)
11c44f5e: posts small blind $0.01
5537777d: posts big blind $0.02
*** HOLE CARDS ***
Dealt to a99c046 
Dealt to 11c44f5e 
Dealt to 5537777d 
Dealt to Hero [Ts 8s 4s 6d]
Dealt to 1b375f65 
Dealt to ef250f8e 
Hero: folds
1b375f65: folds
ef250f8e: folds
a99c046: calls $0.02
11c44f5e: folds
5537777d: raises $0.05 to $0.07
a99c046: calls $0.05
*** FLOP *** [Kd Js 3d]
5537777d: bets $0.12
a99c046: calls $0.12
*** TURN *** [Kd Js 3d] [7c]
5537777d: bets $0.3
a99c046: calls $0.3
*** RIVER *** [Kd Js 3d 7c] [9d]
5537777d: checks
a99c046: bets $0.99
5537777d: folds
Uncalled bet ($0.99) returned to a99c046
*** SHOWDOWN ***
a99c046 collected $0.92 from pot
*** SUMMARY ***
Total pot $0.99 | Rake $0.04 | Jackpot $0.03 | Bingo $0
Board [Kd Js 3d 7c 9d]
Seat 1: a99c046 (button) won ($0.92)
Seat 2: 11c44f5e (small blind) folded before Flop
Seat 3: 5537777d (big blind) folded on the River
Seat 4: Hero folded before Flop (didn't bet)
Seat 5: 1b375f65 folded before Flop (didn't bet)
Seat 6: ef250f8e folded before Flop (didn't bet)


Poker Hand #RC211920885: Omaha Pot Limit  ($0.01/$0.02) - 2022/10/21 11:56:31
Table 'RushAndCash1770885' 6-max Seat #1 is the button
Seat 1: Hero ($2.09 in chips)
Seat 2: b8bdc23f ($2.87 in chips)
Seat 3: 7badf949 ($3.67 in chips)
Seat 4: 9df7c63c ($8.66 in chips)
Seat 5: a3bead37 ($1.13 in chips)
Seat 6: c778956a ($7.97 in chips)
b8bdc23f: posts small blind $0.01
7badf949: posts big blind $0.02
*** HOLE CARDS ***
Dealt to Hero [Ts 2h 6c 6s]
Dealt to b8bdc23f 
Dealt to 7badf949 
Dealt to 9df7c63c 
Dealt to a3bead37 
Dealt to c778956a 
9df7c63c: folds
a3bead37: raises $0.02 to $0.04
c778956a: folds
Hero: folds
b8bdc23f: folds
7badf949: calls $0.02
*** FLOP *** [Jh Ah Qc]
7badf949: checks
a3bead37: checks
*** TURN *** [Jh Ah Qc] [8c]
7badf949: bets $0.05
a3bead37: folds
Uncalled bet ($0.05) returned to 7badf949
*** SHOWDOWN ***
7badf949 collected $0.09 from pot
*** SUMMARY ***
Total pot $0.09 | Rake $0 | Jackpot $0 | Bingo $0
Board [Jh Ah Qc 8c]
Seat 1: Hero (button) folded before Flop (didn't bet)
Seat 2: b8bdc23f (small blind) folded before Flop
Seat 3: 7badf949 (big blind) won ($0.09)
Seat 4: 9df7c63c folded before Flop (didn't bet)
Seat 5: a3bead37 folded on the Turn
Seat 6: c778956a folded before Flop (didn't bet)


Poker Hand #RC211920878: Omaha Pot Limit  ($0.01/$0.02) - 2022/10/21 11:56:27
Table 'RushAndCash1770878' 6-max Seat #1 is the button
Seat 1: b8bdc23f ($2.87 in chips)
Seat 2: Hero ($2.1 in chips)
Seat 3: ffe38b0e ($2.03 in chips)
Seat 4: df55d355 ($4.48 in chips)
Seat 5: 7badf949 ($3.67 in chips)
Seat 6: 76b0f983 ($8.9 in chips)
Hero: posts small blind $0.01
ffe38b0e: posts big blind $0.02
*** HOLE CARDS ***
Dealt to b8bdc23f 
Dealt to Hero [2d Kh 8d 6h]
Dealt to ffe38b0e 
Dealt to df55d355 
Dealt to 7badf949 
Dealt to 76b0f983 
df55d355: raises $0.05 to $0.07
7badf949: folds
76b0f983: folds
b8bdc23f: folds
Hero: folds
ffe38b0e: folds
Uncalled bet ($0.05) returned to df55d355
*** SHOWDOWN ***
df55d355 collected $0.05 from pot
*** SUMMARY ***
Total pot $0.05 | Rake $0 | Jackpot $0 | Bingo $0
Seat 1: b8bdc23f (button) folded before Flop (didn't bet)
Seat 2: Hero (small blind) folded before Flop
Seat 3: ffe38b0e (big blind) folded before Flop
Seat 4: df55d355 collected ($0.05)
Seat 5: 7badf949 folded before Flop (didn't bet)
Seat 6: 76b0f983 folded before Flop (didn't bet)


Poker Hand #RC211920811: Omaha Pot Limit  ($0.01/$0.02) - 2022/10/21 11:55:50
Table 'RushAndCash1770811' 6-max Seat #1 is the button
Seat 1: 1cecdaa3 ($3.97 in chips)
Seat 2: ffe38b0e ($2.19 in chips)
Seat 3: Hero ($1.95 in chips)
Seat 4: 4066da82 ($5.88 in chips)
Seat 5: d85c7b89 ($2 in chips)
Seat 6: 7cc03d50 ($2.39 in chips)
ffe38b0e: posts small blind $0.01
Hero: posts big blind $0.02
*** HOLE CARDS ***
Dealt to 1cecdaa3 
Dealt to ffe38b0e 
Dealt to Hero [Kd 7c Kc Ac]
Dealt to 4066da82 
Dealt to d85c7b89 
Dealt to 7cc03d50 
4066da82: folds
d85c7b89: folds
7cc03d50: folds
1cecdaa3: folds
ffe38b0e: raises $0.04 to $0.06
Hero: calls $0.04
*** FLOP *** [4h Qd 2d]
ffe38b0e: checks
Hero: checks
*** TURN *** [4h Qd 2d] [Ts]
ffe38b0e: checks
Hero: checks
*** RIVER *** [4h Qd 2d Ts] [Td]
ffe38b0e: bets $0.1
Hero: calls $0.1
ffe38b0e: shows [6c 8h 9c 8c] (Pair of Tens and Pair of Eights)
Hero: shows [Kd 7c Kc Ac] (Pair of Kings and Pair of Tens)
*** SHOWDOWN ***
Hero collected $0.31 from pot
*** SUMMARY ***
Total pot $0.32 | Rake $0.01 | Jackpot $0 | Bingo $0
Board [4h Qd 2d Ts Td]
Seat 1: 1cecdaa3 (button) folded before Flop (didn't bet)
Seat 2: ffe38b0e (small blind) showed [6c 8h 9c 8c] and lost with Pair of Tens and Pair of Eights
Seat 3: Hero (big blind) showed [Kd 7c Kc Ac] and won ($0.31) with Pair of Kings and Pair of Tens
Seat 4: 4066da82 folded before Flop (didn't bet)
Seat 5: d85c7b89 folded before Flop (didn't bet)
Seat 6: 7cc03d50 folded before Flop (didn't bet)


Poker Hand #RC211920804: Omaha Pot Limit  ($0.01/$0.02) - 2022/10/21 11:55:47
Table 'RushAndCash1770804' 6-max Seat #1 is the button
Seat 1: 5d4cd06b ($5.56 in chips)
Seat 2: 7cc03d50 ($2.4 in chips)
Seat 3: e98aa1a0 ($1.99 in chips)
Seat 4: 7a8732b1 ($17.42 in chips)
Seat 5: Hero ($1.95 in chips)
Seat 6: 859242b8 ($2 in chips)
7cc03d50: posts small blind $0.01
e98aa1a0: posts big blind $0.02
*** HOLE CARDS ***
Dealt to 5d4cd06b 
Dealt to 7cc03d50 
Dealt to e98aa1a0 
Dealt to 7a8732b1 
Dealt to Hero [5c 9s Kh 6c]
Dealt to 859242b8 
7a8732b1: folds
Hero: folds
859242b8: folds
5d4cd06b: folds
7cc03d50: folds
Uncalled bet ($0.01) returned to e98aa1a0
*** SHOWDOWN ***
e98aa1a0 collected $0.02 from pot
*** SUMMARY ***
Total pot $0.02 | Rake $0 | Jackpot $0 | Bingo $0
Seat 1: 5d4cd06b (button) folded before Flop (didn't bet)
Seat 2: 7cc03d50 (small blind) folded before Flop
Seat 3: e98aa1a0 (big blind) collected ($0.02)
Seat 4: 7a8732b1 folded before Flop (didn't bet)
Seat 5: Hero folded before Flop (didn't bet)
Seat 6: 859242b8 folded before Flop (didn't bet)


Poker Hand #RC211920797: Omaha Pot Limit  ($0.01/$0.02) - 2022/10/21 11:55:43
Table 'RushAndCash1770797' 6-max Seat #1 is the button
Seat 1: b8bdc23f ($2.82 in chips)
Seat 2: eec155ea ($2.31 in chips)
Seat 3: f3969067 ($1.51 in chips)
Seat 4: 40974004 ($4.5 in chips)
Seat 5: 5a08a52b ($3.37 in chips)
Seat 6: Hero ($1.95 in chips)
eec155ea: posts small blind $0.01
f3969067: posts big blind $0.02
*** HOLE CARDS ***
Dealt to b8bdc23f 
Dealt to eec155ea 
Dealt to f3969067 
Dealt to 40974004 
Dealt to 5a08a52b 
Dealt to Hero [5h 8c Jh Qs]
40974004: folds
5a08a52b: folds
Hero: folds
b8bdc23f: raises $0.04 to $0.06
eec155ea: folds
f3969067: calls $0.04
*** FLOP *** [Kd Js 3d]
f3969067: checks
b8bdc23f: bets $0.07
f3969067: folds
Uncalled bet ($0.07) returned to b8bdc23f
*** SHOWDOWN ***
b8bdc23f collected $0.13 from pot
*** SUMMARY ***
Total pot $0.13 | Rake $0 | Jackpot $0 | Bingo $0
Board [Kd Js 3d]
Seat 1: b8bdc23f (button) won ($0.13)
Seat 2: eec155ea (small blind) folded before Flop
Seat 3: f3969067 (big blind) folded on the Flop
Seat 4: 40974004 folded before Flop (didn't bet)
Seat 5: 5a08a52b folded before Flop (didn't bet)
Seat 6: Hero folded before Flop (didn't bet)


Poker Hand #RC211920788: Omaha Pot Limit  ($0.01/$0.02) - 2022/10/21 11:55:39
Table 'RushAndCash1770788' 6-max Seat #1 is the button
Seat 1: 1a915997 ($0.75 in chips)
Seat 2: 6fad80d4 ($5.54 in chips)
Seat 3: f254fa50 ($2.06 in chips)
Seat 4: Hero ($1.95 in chips)
Seat 5: ad0bd7ed ($4.51 in chips)
Seat 6: 4638ee2a ($2 in chips)
6fad80d4: posts small blind $0.01
f254fa50: posts big blind $0.02
*** HOLE CARDS ***
Dealt to 1a915997 
Dealt to 6fad80d4 
Dealt to f254fa50 
Dealt to Hero [Ks 9h 2s 4s]
Dealt to ad0bd7ed 
Dealt to 4638ee2a 
Hero: folds
ad0bd7ed: folds
4638ee2a: folds
1a915997: calls $0.02
6fad80d4: folds
f254fa50: checks
*** FLOP *** [4c Qc Qd]
f254fa50: checks
1a915997: checks
*** TURN *** [4c Qc Qd] [5s]
f254fa50: checks
1a915997: bets $0.02
f254fa50: folds
Uncalled bet ($0.02) returned to 1a915997
*** SHOWDOWN ***
1a915997 collected $0.05 from pot
*** SUMMARY ***
Total pot $0.05 | Rake $0 | Jackpot $0 | Bingo $0
Board [4c Qc Qd 5s]
Seat 1: 1a915997 (button) won ($0.05)
Seat 2: 6fad80d4 (small blind) folded before Flop
Seat 3: f254fa50 (big blind) folded on the Turn
Seat 4: Hero folded before Flop (didn't bet)
Seat 5: ad0bd7ed folded before Flop (didn't bet)
Seat 6: 4638ee2a folded before Flop (didn't bet)


Poker Hand #RC211920780: Omaha Pot Limit  ($0.01/$0.02) - 2022/10/21 11:55:35
Table 'RushAndCash1770780' 6-max Seat #1 is the button
Seat 1: Hero ($1.95 in chips)
Seat 2: 1b375f65 ($6.69 in chips)
Seat 3: 391f869d ($1.75 in chips)
Seat 4: 740e8ca8 ($2.18 in chips)
Seat 5: 2df75ecf ($2.84 in chips)
Seat 6: b37d22b5 ($2.25 in chips)
1b375f65: posts small blind $0.01
391f869d: posts big blind $0.02
*** HOLE CARDS ***
Dealt to Hero [5s Ac Jc 7d]
Dealt to 1b375f65 
Dealt to 391f869d 
Dealt to 740e8ca8 
Dealt to 2df75ecf 
Dealt to b37d22b5 
740e8ca8: folds
2df75ecf: raises $0.02 to $0.04
b37d22b5: folds
Hero: folds
1b375f65: calls $0.03
391f869d: calls $0.02
*** FLOP *** [3s 3h 2s]
1b375f65: checks
391f869d: checks
2df75ecf: checks
*** TURN *** [3s 3h 2s] [8s]
1b375f65: bets $0.12
391f869d: folds
2df75ecf: folds
Uncalled bet ($0.12) returned to 1b375f65
*** SHOWDOWN ***
1b375f65 collected $0.12 from pot
*** SUMMARY ***
Total pot $0.12 | Rake $0 | Jackpot $0 | Bingo $0
Board [3s 3h 2s 8s]
Seat 1: Hero (button) folded before Flop (didn't bet)
Seat 2: 1b375f65 (small blind) won ($0.12)
Seat 3: 391f869d (big blind) folded on the Turn
Seat 4: 740e8ca8 folded before Flop (didn't bet)
Seat 5: 2df75ecf folded on the Turn
Seat 6: b37d22b5 folded before Flop (didn't bet)


Poker Hand #RC211920729: Omaha Pot Limit  ($0.01/$0.02) - 2022/10/21 11:55:05
Table 'RushAndCash1770729' 6-max Seat #1 is the button
Seat 1: 525ab364 ($2.35 in chips)
Seat 2: Hero ($2.01 in chips)
Seat 3: 740e8ca8 ($2.12 in chips)
Seat 4: c778956a ($7.97 in chips)
Seat 5: ad0bd7ed ($4.49 in chips)
Seat 6: 71c24ec5 ($4.85 in chips)
Hero: posts small blind $0.01
740e8ca8: posts big blind $0.02
*** HOLE CARDS ***
Dealt to 525ab364 
Dealt to Hero [As 5s Tc 2d]
Dealt to 740e8ca8 
Dealt to c778956a 
Dealt to ad0bd7ed 
Dealt to 71c24ec5 
c778956a: folds
ad0bd7ed: folds
71c24ec5: folds
525ab364: folds
Hero: raises $0.04 to $0.06
740e8ca8: calls $0.04
*** FLOP *** [4c Qs Th]
Hero: checks
740e8ca8: bets $0.12
Hero: folds
Uncalled bet ($0.12) returned to 740e8ca8
*** SHOWDOWN ***
740e8ca8 collected $0.12 from pot
*** SUMMARY ***
Total pot $0.12 | Rake $0 | Jackpot $0 | Bingo $0
Board [4c Qs Th]
Seat 1: 525ab364 (button) folded before Flop (didn't bet)
Seat 2: Hero (small blind) folded on the Flop
Seat 3: 740e8ca8 (big blind) won ($0.12)
Seat 4: c778956a folded before Flop (didn't bet)
Seat 5: ad0bd7ed folded before Flop (didn't bet)
Seat 6: 71c24ec5 folded before Flop (didn't bet)


Poker Hand #RC211920723: Omaha Pot Limit  ($0.01/$0.02) - 2022/10/21 11:55:01
Table 'RushAndCash1770723' 6-max Seat #1 is the button
Seat 1: 27602231 ($1.54 in chips)
Seat 2: a6896bf1 ($2.01 in chips)
Seat 3: Hero ($2.03 in chips)
Seat 4: 5537777d ($2 in chips)
Seat 5: 70f7f662 ($8.59 in chips)
Seat 6: aece90cc ($2 in chips)
a6896bf1: posts small blind $0.01
Hero: posts big blind $0.02
*** HOLE CARDS ***
Dealt to 27602231 
Dealt to a6896bf1 
Dealt to Hero [6c Jc 4d 2h]
Dealt to 5537777d 
Dealt to 70f7f662 
Dealt to aece90cc 
5537777d: raises $0.05 to $0.07
70f7f662: folds
aece90cc: folds
27602231: raises $0.17 to $0.24
a6896bf1: calls $0.23
Hero: folds
5537777d: raises $0.74 to $0.98
27602231: raises $0.56 to $1.54 and is all-in
a6896bf1: raises $0.47 to $2.01 and is all-in
5537777d: calls $1.02 and is all-in
Uncalled bet ($0.01) returned to a6896bf1
a6896bf1: shows [Kc 5d Ad 8c]
5537777d: shows [3h Ac Ah 9c]
27602231: shows [Kd Tc 4s Ks]
*** FLOP *** [6s Qd 8h]
*** TURN *** [6s Qd 8h] [9s]
*** RIVER *** [6s Qd 8h 9s] [5c]
*** SHOWDOWN ***
a6896bf1 collected $4.56 from pot
a6896bf1 collected $0.92 from pot
*** SUMMARY ***
Total pot $5.56 | Rake $0.05 | Jackpot $0.03 | Bingo $0
Board [6s Qd 8h 9s 5c]
Seat 1: 27602231 (button) showed [Kd Tc 4s Ks] and lost with Pair of Kings
Seat 2: a6896bf1 (small blind) showed [Kc 5d Ad 8c] and won ($5.48) with Pair of Eights and Pair of Fives
Seat 3: Hero (big blind) folded before Flop
Seat 4: 5537777d showed [3h Ac Ah 9c] and lost with Pair of Aces
Seat 5: 70f7f662 folded before Flop (didn't bet)
Seat 6: aece90cc folded before Flop (didn't bet)


Poker Hand #RC211920708: Omaha Pot Limit  ($0.01/$0.02) - 2022/10/21 11:54:52
Table 'RushAndCash1770708' 6-max Seat #1 is the button
Seat 1: 8cb8a924 ($4.32 in chips)
Seat 2: aece90cc ($2 in chips)
Seat 3: dd136d0c ($1.68 in chips)
Seat 4: Hero ($2.03 in chips)
Seat 5: 1eedbfa3 ($7.43 in chips)
Seat 6: bac1f0b3 ($11.77 in chips)
aece90cc: posts small blind $0.01
dd136d0c: posts big blind $0.02
*** HOLE CARDS ***
Dealt to 8cb8a924 
Dealt to aece90cc 
Dealt to dd136d0c 
Dealt to Hero [7c 5h Qd 8d]
Dealt to 1eedbfa3 
Dealt to bac1f0b3 
Hero: folds
1eedbfa3: folds
bac1f0b3: folds
8cb8a924: raises $0.02 to $0.04
aece90cc: folds
dd136d0c: folds
Uncalled bet ($0.02) returned to 8cb8a924
*** SHOWDOWN ***
8cb8a924 collected $0.05 from pot
*** SUMMARY ***
Total pot $0.05 | Rake $0 | Jackpot $0 | Bingo $0
Seat 1: 8cb8a924 (button) collected ($0.05)
Seat 2: aece90cc (small blind) folded before Flop
Seat 3: dd136d0c (big blind) folded before Flop
Seat 4: Hero folded before Flop (didn't bet)
Seat 5: 1eedbfa3 folded before Flop (didn't bet)
Seat 6: bac1f0b3 folded before Flop (didn't bet)


Poker Hand #RC211920699: Omaha Pot Limit  ($0.01/$0.02) - 2022/10/21 11:54:48
Table 'RushAndCash1770699' 6-max Seat #1 is the button
Seat 1: 5537777d ($2 in chips)
Seat 2: 86010f0f ($6.18 in chips)
Seat 3: 3d8b598e ($4.68 in chips)
Seat 4: caac9df ($3.59 in chips)
Seat 5: cfbaf2a9 ($2 in chips)
Seat 6: Hero ($2.03 in chips)
86010f0f: posts small blind $0.01
3d8b598e: posts big blind $0.02
*** HOLE CARDS ***
Dealt to 5537777d 
Dealt to 86010f0f 
Dealt to 3d8b598e 
Dealt to caac9df 
Dealt to cfbaf2a9 
Dealt to Hero [8c Tc 4c 7c]
caac9df: folds
cfbaf2a9: folds
Hero: folds
5537777d: folds
86010f0f: folds
Uncalled bet ($0.01) returned to 3d8b598e
*** SHOWDOWN ***
3d8b598e collected $0.02 from pot
*** SUMMARY ***
Total pot $0.02 | Rake $0 | Jackpot $0 | Bingo $0
Seat 1: 5537777d (button) folded before Flop (didn't bet)
Seat 2: 86010f0f (small blind) folded before Flop
Seat 3: 3d8b598e (big blind) collected ($0.02)
Seat 4: caac9df folded before Flop (didn't bet)
Seat 5: cfbaf2a9 folded before Flop (didn't bet)
Seat 6: Hero folded before Flop (didn't bet)


Poker Hand #RC211920674: Omaha Pot Limit  ($0.01/$0.02) - 2022/10/21 11:54:34
Table 'RushAndCash1770674' 6-max Seat #1 is the button
Seat 1: 45bc3a44 ($1.17 in chips)
Seat 2: 971ded4e ($2.05 in chips)
Seat 3: 18acf854 ($1.9 in chips)
Seat 4: aece90cc ($2 in chips)
Seat 5: 2a6251a4 ($2.17 in chips)
Seat 6: Hero ($2.03 in chips)
971ded4e: posts small blind $0.01
18acf854: posts big blind $0.02
*** HOLE CARDS ***
Dealt to 45bc3a44 
Dealt to 971ded4e 
Dealt to 18acf854 
Dealt to aece90cc 
Dealt to 2a6251a4 
Dealt to Hero [8c 2d Qd 9d]
aece90cc: folds
2a6251a4: folds
Hero: folds
45bc3a44: folds
971ded4e: folds
Uncalled bet ($0.01) returned to 18acf854
*** SHOWDOWN ***
18acf854 collected $0.02 from pot
*** SUMMARY ***
Total pot $0.02 | Rake $0 | Jackpot $0 | Bingo $0
Seat 1: 45bc3a44 (button) folded before Flop (didn't bet)
Seat 2: 971ded4e (small blind) folded before Flop
Seat 3: 18acf854 (big blind) collected ($0.02)
Seat 4: aece90cc folded before Flop (didn't bet)
Seat 5: 2a6251a4 folded before Flop (didn't bet)
Seat 6: Hero folded before Flop (didn't bet)


Poker Hand #RC211920641: Omaha Pot Limit  ($0.01/$0.02) - 2022/10/21 11:54:16
Table 'RushAndCash1770641' 6-max Seat #1 is the button
Seat 1: 6fefdc42 ($2 in chips)
Seat 2: aa326dc9 ($0.08 in chips)
Seat 3: c4085c4d ($0.55 in chips)
Seat 4: Hero ($2 in chips)
Seat 5: 4377f8af ($3.23 in chips)
Seat 6: aa88fa2d ($3.43 in chips)
aa326dc9: posts small blind $0.01
c4085c4d: posts big blind $0.02
*** HOLE CARDS ***
Dealt to 6fefdc42 
Dealt to aa326dc9 
Dealt to c4085c4d 
Dealt to Hero [As Ts 6c 3h]
Dealt to 4377f8af 
Dealt to aa88fa2d 
Hero: raises $0.04 to $0.06
4377f8af: folds
aa88fa2d: folds
6fefdc42: folds
aa326dc9: folds
c4085c4d: folds
Uncalled bet ($0.04) returned to Hero
*** SHOWDOWN ***
Hero collected $0.05 from pot
*** SUMMARY ***
Total pot $0.05 | Rake $0 | Jackpot $0 | Bingo $0
Seat 1: 6fefdc42 (button) folded before Flop (didn't bet)
Seat 2: aa326dc9 (small blind) folded before Flop
Seat 3: c4085c4d (big blind) folded before Flop
Seat 4: Hero collected ($0.05)
Seat 5: 4377f8af folded before Flop (didn't bet)
Seat 6: aa88fa2d folded before Flop (didn't bet)


Poker Hand #RC211920632: Omaha Pot Limit  ($0.01/$0.02) - 2022/10/21 11:54:10
Table 'RushAndCash1770632' 6-max Seat #1 is the button
Seat 1: Hero ($1.97 in chips)
Seat 2: 97978ed ($3.06 in chips)
Seat 3: aa326dc9 ($0.1 in chips)
Seat 4: 4859f1fc ($2.8 in chips)
Seat 5: 8c240e93 ($2 in chips)
Seat 6: e50b2b4d ($2.15 in chips)
97978ed: posts small blind $0.01
aa326dc9: posts big blind $0.02
*** HOLE CARDS ***
Dealt to Hero [Ah 7d Jc 6h]
Dealt to 97978ed 
Dealt to aa326dc9 
Dealt to 4859f1fc 
Dealt to 8c240e93 
Dealt to e50b2b4d 
4859f1fc: folds
8c240e93: raises $0.05 to $0.07
e50b2b4d: raises $0.17 to $0.24
Hero: folds
97978ed: folds
aa326dc9: folds
8c240e93: raises $0.51 to $0.75
e50b2b4d: calls $0.51
*** FLOP *** [Ks 9s 7h]
8c240e93: bets $1.25 and is all-in
e50b2b4d: calls $1.25
8c240e93: shows [Kh 6s Qs As] (Pair of Kings)
e50b2b4d: shows [Jh 8c Qd 6d] (King-High)
*** TURN *** [Ks 9s 7h] [6c]
*** RIVER *** [Ks 9s 7h 6c] [8h]
*** SHOWDOWN ***
8c240e93 collected $3.94 from pot
*** SUMMARY ***
Total pot $4.03 | Rake $0.06 | Jackpot $0.03 | Bingo $0
Board [Ks 9s 7h 6c 8h]
Seat 1: Hero (button) folded before Flop (didn't bet)
Seat 2: 97978ed (small blind) folded before Flop
Seat 3: aa326dc9 (big blind) folded before Flop
Seat 4: 4859f1fc folded before Flop (didn't bet)
Seat 5: 8c240e93 showed [Kh 6s Qs As] and won ($3.94) with Pair of Kings and Pair of Sixes
Seat 6: e50b2b4d showed [Jh 8c Qd 6d] and lost with Pair of Eights and Pair of Sixes


Poker Hand #RC211920626: Omaha Pot Limit  ($0.01/$0.02) - 2022/10/21 11:54:06
Table 'RushAndCash1770626' 6-max Seat #1 is the button
Seat 1: c4085c4d ($0.56 in chips)
Seat 2: Hero ($1.98 in chips)
Seat 3: 132715bc ($2 in chips)
Seat 4: f2e2bb8f ($2.04 in chips)
Seat 5: 8553cac6 ($5.17 in chips)
Seat 6: ef250f8e ($2.03 in chips)
Hero: posts small blind $0.01
132715bc: posts big blind $0.02
*** HOLE CARDS ***
Dealt to c4085c4d 
Dealt to Hero [Jd 8d 9s 6s]
Dealt to 132715bc 
Dealt to f2e2bb8f 
Dealt to 8553cac6 
Dealt to ef250f8e 
f2e2bb8f: folds
8553cac6: folds
ef250f8e: folds
c4085c4d: folds
Hero: folds
Uncalled bet ($0.01) returned to 132715bc
*** SHOWDOWN ***
132715bc collected $0.02 from pot
*** SUMMARY ***
Total pot $0.02 | Rake $0 | Jackpot $0 | Bingo $0
Seat 1: c4085c4d (button) folded before Flop (didn't bet)
Seat 2: Hero (small blind) folded before Flop
Seat 3: 132715bc (big blind) collected ($0.02)
Seat 4: f2e2bb8f folded before Flop (didn't bet)
Seat 5: 8553cac6 folded before Flop (didn't bet)
Seat 6: ef250f8e folded before Flop (didn't bet)


Poker Hand #RC211920619: Omaha Pot Limit  ($0.01/$0.02) - 2022/10/21 11:54:03
Table 'RushAndCash1770619' 6-max Seat #1 is the button
Seat 1: f2e2bb8f ($2.04 in chips)
Seat 2: eb187af5 ($2.04 in chips)
Seat 3: Hero ($2 in chips)
Seat 4: 5b3b559a ($2.24 in chips)
Seat 5: aa88fa2d ($3.45 in chips)
Seat 6: c4085c4d ($0.56 in chips)
eb187af5: posts small blind $0.01
Hero: posts big blind $0.02
*** HOLE CARDS ***
Dealt to f2e2bb8f 
Dealt to eb187af5 
Dealt to Hero [4s 2h 6d 6s]
Dealt to 5b3b559a 
Dealt to aa88fa2d 
Dealt to c4085c4d 
5b3b559a: folds
aa88fa2d: folds
c4085c4d: folds
f2e2bb8f: folds
eb187af5: folds
Uncalled bet ($0.01) returned to Hero
*** SHOWDOWN ***
Hero collected $0.02 from pot
*** SUMMARY ***
Total pot $0.02 | Rake $0 | Jackpot $0 | Bingo $0
Seat 1: f2e2bb8f (button) folded before Flop (didn't bet)
Seat 2: eb187af5 (small blind) folded before Flop
Seat 3: Hero (big blind) collected ($0.02)
Seat 4: 5b3b559a folded before Flop (didn't bet)
Seat 5: aa88fa2d folded before Flop (didn't bet)
Seat 6: c4085c4d folded before Flop (didn't bet)


